data,stato,codice_regione,denominazione_regione,lat,long,ricoverati_con_sintomi,terapia_intensiva,totale_ospedalizzati,isolamento_domiciliare,totale_positivi,variazione_totale_positivi,nuovi_positivi,dimessi_guariti,deceduti,totale_casi,tamponi,casi_testati,note_it,note_en
<<<<<<< HEAD
<<<<<<< HEAD
<<<<<<< HEAD
<<<<<<< HEAD
<<<<<<< HEAD
<<<<<<< HEAD
<<<<<<< HEAD
<<<<<<< HEAD
<<<<<<< HEAD
<<<<<<< HEAD
<<<<<<< HEAD
<<<<<<< HEAD
2020-05-05T17:00:00,ITA,13,Abruzzo,42.35122196,13.39843823,289,11,300,1509,1809,-28,25,881,335,3025,42489,30835,,
2020-05-05T17:00:00,ITA,17,Basilicata,40.63947052,15.80514834,50,3,53,124,177,4,10,194,25,396,15476,15028,,
2020-05-05T17:00:00,ITA,04,P.A. Bolzano,46.49933453,11.35662422,99,11,110,502,612,-24,1,1644,286,2542,45264,20561,,
2020-05-05T17:00:00,ITA,18,Calabria,38.90597598,16.59440194,92,4,96,554,650,-24,1,381,88,1119,40509,38461,,
2020-05-05T17:00:00,ITA,15,Campania,40.83956555,14.25084984,408,25,433,2097,2530,-181,20,1619,369,4518,93068,48733,,
2020-05-05T17:00:00,ITA,08,Emilia-Romagna,44.49436681,11.3417208,1917,191,2108,6573,8681,-303,100,13889,3705,26275,206166,136310,,
2020-05-05T17:00:00,ITA,06,Friuli Venezia Giulia,45.6494354,13.76813649,120,4,124,860,984,-66,9,1798,303,3085,78510,50135,,
2020-05-05T17:00:00,ITA,12,Lazio,41.89277044,12.48366722,1315,91,1406,2964,4370,-15,67,2010,534,6914,157307,122541,,
2020-05-05T17:00:00,ITA,07,Liguria,44.41149315,8.9326992,583,68,651,2776,3427,-81,63,3816,1232,8475,57622,36150,,
2020-05-05T17:00:00,ITA,03,Lombardia,45.46679409,9.190347404,6201,509,6710,30382,37092,-215,500,27124,14389,78605,425290,255292,,
2020-05-05T17:00:00,ITA,11,Marche,43.61675973,13.5188753,387,42,429,2790,3219,13,29,2237,936,6392,67256,44045,,
2020-05-05T17:00:00,ITA,14,Molise,41.55774754,14.65916051,9,1,10,167,177,-1,0,102,22,301,7528,7252,,
2020-05-05T17:00:00,ITA,01,Piemonte,45.0732745,7.680687483,2307,155,2462,12861,15323,-239,152,9235,3216,27774,181316,126685,,
2020-05-05T17:00:00,ITA,16,Puglia,41.12559576,16.86736689,384,39,423,2516,2939,-6,17,798,433,4170,69128,67238,,
2020-05-05T17:00:00,ITA,20,Sardegna,39.21531192,9.110616306,94,9,103,539,642,-11,1,557,119,1318,28867,25631,,
2020-05-05T17:00:00,ITA,19,Sicilia,38.11569725,13.3623567,367,26,393,1809,2202,0,12,818,247,3267,91306,82079,,
2020-05-05T17:00:00,ITA,09,Toscana,43.76923077,11.25588885,484,111,595,4595,5190,-89,30,3552,889,9631,157260,118265,,
2020-05-05T17:00:00,ITA,04,P.A. Trento,46.06893511,11.12123097,126,15,141,900,1041,-124,3,2787,433,4261,42870,25137,,
2020-05-05T17:00:00,ITA,10,Umbria,43.10675841,12.38824698,56,11,67,109,176,-5,6,1154,70,1400,39998,27822,,
2020-05-05T17:00:00,ITA,02,Valle d'Aosta,45.73750286,7.320149366,56,3,59,51,110,0,0,894,139,1143,8484,6342,,
2020-05-05T17:00:00,ITA,05,Veneto,45.43490485,12.33845213,926,98,1024,6092,7116,-118,29,9741,1545,18402,390952,227579,,
=======
2020-05-06T17:00:00,ITA,13,Abruzzo,42.35122196,13.39843823,285,11,296,1495,1791,-18,22,915,341,3047,43803,31502,,
2020-05-06T17:00:00,ITA,17,Basilicata,40.63947052,15.80514834,47,3,50,122,172,-5,3,202,25,399,16103,15619,,
2020-05-06T17:00:00,ITA,04,P.A. Bolzano,46.49933453,11.35662422,99,11,110,469,579,-33,1,1678,286,2543,46228,20872,,
2020-05-06T17:00:00,ITA,18,Calabria,38.90597598,16.59440194,87,3,90,554,644,-6,3,389,89,1122,41828,39780,,
2020-05-06T17:00:00,ITA,15,Campania,40.83956555,14.25084984,433,25,458,1882,2340,-190,14,1816,376,4532,96548,49478,,
2020-05-06T17:00:00,ITA,08,Emilia-Romagna,44.49436681,11.3417208,1816,176,1992,6399,8391,-290,104,14251,3737,26379,211652,138871,,
2020-05-06T17:00:00,ITA,06,Friuli Venezia Giulia,45.6494354,13.76813649,115,3,118,844,962,-22,9,1826,306,3094,79429,50698,,
2020-05-06T17:00:00,ITA,12,Lazio,41.89277044,12.48366722,1351,91,1442,2991,4433,63,81,2024,538,6995,160894,125897,,
2020-05-06T17:00:00,ITA,07,Liguria,44.41149315,8.9326992,548,59,607,2699,3306,-121,76,4002,1243,8551,59693,37177,,
2020-05-06T17:00:00,ITA,03,Lombardia,45.46679409,9.190347404,6079,480,6559,25194,31753,-5339,764,33005,14611,79369,439806,262964,dc-IT-0020,dc-EN-0020
2020-05-06T17:00:00,ITA,11,Marche,43.61675973,13.5188753,353,42,395,2841,3236,17,29,2242,943,6421,69037,45026,,
2020-05-06T17:00:00,ITA,14,Molise,41.55774754,14.65916051,9,0,9,170,179,2,3,103,22,304,7896,7604,,
2020-05-06T17:00:00,ITA,01,Piemonte,45.0732745,7.680687483,2147,150,2297,12561,14858,-465,165,9834,3247,27939,188057,131269,,
2020-05-06T17:00:00,ITA,16,Puglia,41.12559576,16.86736689,365,36,401,2502,2903,-36,26,855,438,4196,70944,68760,,
2020-05-06T17:00:00,ITA,20,Sardegna,39.21531192,9.110616306,91,11,102,521,623,-19,1,577,119,1319,29966,26598,,
2020-05-06T17:00:00,ITA,19,Sicilia,38.11569725,13.3623567,359,25,384,1817,2201,-1,14,830,250,3281,92999,83908,,
2020-05-06T17:00:00,ITA,09,Toscana,43.76923077,11.25588885,462,92,554,4534,5088,-102,26,3670,899,9657,161553,121066,,
2020-05-06T17:00:00,ITA,04,P.A. Trento,46.06893511,11.12123097,116,13,129,853,982,-59,19,2861,437,4280,44719,26161,,
2020-05-06T17:00:00,ITA,10,Umbria,43.10675841,12.38824698,55,9,64,107,171,-5,4,1163,70,1404,41328,28712,,
2020-05-06T17:00:00,ITA,02,Valle d'Aosta,45.73750286,7.320149366,50,3,53,74,127,17,3,880,139,1146,8640,6461,,
2020-05-06T17:00:00,ITA,05,Veneto,45.43490485,12.33845213,902,90,992,5797,6789,-327,77,10122,1568,18479,399806,231469,,
>>>>>>> upstream/master
=======
2020-05-07T17:00:00,ITA,13,Abruzzo,42.35122196,13.39843823,263,12,275,1495,1770,-21,25,954,348,3072,45021,32186,,
2020-05-07T17:00:00,ITA,17,Basilicata,40.63947052,15.80514834,48,2,50,105,155,-17,-16,202,26,383,16272,15780,dc-IT-0022,dc-EN-0022
2020-05-07T17:00:00,ITA,04,P.A. Bolzano,46.49933453,11.35662422,87,11,98,453,551,-28,9,1715,286,2552,47091,21284,,
2020-05-07T17:00:00,ITA,18,Calabria,38.90597598,16.59440194,81,2,83,550,633,-11,3,403,89,1125,42854,40806,,
2020-05-07T17:00:00,ITA,15,Campania,40.83956555,14.25084984,415,27,442,1697,2139,-201,9,2023,379,4541,101025,50463,,
2020-05-07T17:00:00,ITA,08,Emilia-Romagna,44.49436681,11.3417208,1726,173,1899,6112,8011,-380,108,14710,3766,26487,217039,141468,,
2020-05-07T17:00:00,ITA,06,Friuli Venezia Giulia,45.6494354,13.76813649,109,2,111,816,927,-35,13,1872,308,3107,82012,51123,,
2020-05-07T17:00:00,ITA,12,Lazio,41.89277044,12.48366722,1291,89,1380,2968,4348,-85,39,2143,543,7034,165340,130351,,
2020-05-07T17:00:00,ITA,07,Liguria,44.41149315,8.9326992,525,57,582,2666,3248,-58,94,4143,1254,8645,61446,38071,,
2020-05-07T17:00:00,ITA,03,Lombardia,45.46679409,9.190347404,5848,480,6328,25687,32015,262,720,33329,14745,80089,455294,262964,,
2020-05-07T17:00:00,ITA,11,Marche,43.61675973,13.5188753,328,41,369,2878,3247,11,31,2257,948,6452,71017,46258,,
2020-05-07T17:00:00,ITA,14,Molise,41.55774754,14.65916051,8,0,8,162,170,-9,1,113,22,305,8237,7912,,
2020-05-07T17:00:00,ITA,01,Piemonte,45.0732745,7.680687483,2147,150,2297,12172,14469,-389,196,10384,3282,28135,194584,134567,,
2020-05-07T17:00:00,ITA,16,Puglia,41.12559576,16.86736689,355,35,390,2410,2800,-103,49,1004,441,4245,72796,51638,,
2020-05-07T17:00:00,ITA,20,Sardegna,39.21531192,9.110616306,90,9,99,484,583,-40,5,622,119,1324,31064,27540,,
2020-05-07T17:00:00,ITA,19,Sicilia,38.11569725,13.3623567,349,21,370,1757,2127,-74,7,910,251,3288,95695,85674,,
2020-05-07T17:00:00,ITA,09,Toscana,43.76923077,11.25588885,437,91,528,4188,4716,-372,26,4052,915,9683,166062,124295,,
2020-05-07T17:00:00,ITA,04,P.A. Trento,46.06893511,11.12123097,99,11,110,800,910,-72,3,2935,438,4283,46500,28486,,
2020-05-07T17:00:00,ITA,10,Umbria,43.10675841,12.38824698,47,9,56,85,141,-30,1,1194,70,1405,42788,29708,,
2020-05-07T17:00:00,ITA,02,Valle d'Aosta,45.73750286,7.320149366,49,2,51,79,130,3,4,881,139,1150,8939,6702,,
2020-05-07T17:00:00,ITA,05,Veneto,45.43490485,12.33845213,872,87,959,5575,6534,-255,74,10430,1589,18553,410212,236281,,
>>>>>>> upstream/master
=======
2020-05-08T17:00:00,ITA,13,Abruzzo,42.35122196,13.39843823,250,10,260,1453,1713,-57,6,1014,351,3078,46103,32619,,
2020-05-08T17:00:00,ITA,17,Basilicata,40.63947052,15.80514834,48,2,50,102,152,-3,-1,204,26,382,16777,16285,dc-IT-0024,dc-EN-0024
2020-05-08T17:00:00,ITA,04,P.A. Bolzano,46.49933453,11.35662422,78,9,87,415,502,-49,6,1767,289,2558,47908,21572,,
2020-05-08T17:00:00,ITA,18,Calabria,38.90597598,16.59440194,73,2,75,544,619,-14,1,417,90,1126,43980,41902,,
2020-05-08T17:00:00,ITA,15,Campania,40.83956555,14.25084984,418,28,446,1566,2012,-127,21,2164,386,4562,105399,51402,,
2020-05-08T17:00:00,ITA,08,Emilia-Romagna,44.49436681,11.3417208,1680,163,1843,5887,7730,-281,111,15071,3797,26598,221866,144009,,
2020-05-08T17:00:00,ITA,06,Friuli Venezia Giulia,45.6494354,13.76813649,105,2,107,804,911,-16,9,1897,308,3116,82902,52784,,
2020-05-08T17:00:00,ITA,12,Lazio,41.89277044,12.48366722,1278,84,1362,2966,4328,-20,52,2209,549,7086,169499,133674,,
2020-05-08T17:00:00,ITA,07,Liguria,44.41149315,8.9326992,517,46,563,2613,3176,-72,78,4282,1265,8723,63531,39145,,
2020-05-08T17:00:00,ITA,03,Lombardia,45.46679409,9.190347404,5702,400,6102,25881,31983,-32,634,33901,14839,80723,466287,277106,,
2020-05-08T17:00:00,ITA,11,Marche,43.61675973,13.5188753,303,38,341,2897,3238,-9,18,2278,954,6470,72504,47092,,
2020-05-08T17:00:00,ITA,14,Molise,41.55774754,14.65916051,6,0,6,178,184,14,22,121,22,327,8502,8177,,
2020-05-08T17:00:00,ITA,01,Piemonte,45.0732745,7.680687483,2013,140,2153,11954,14107,-362,233,10956,3305,28368,201183,138830,,
2020-05-08T17:00:00,ITA,16,Puglia,41.12559576,16.86736689,349,33,382,2351,2733,-67,11,1080,443,4256,74724,53194,,
2020-05-08T17:00:00,ITA,20,Sardegna,39.21531192,9.110616306,90,10,100,453,553,-30,6,658,119,1330,32219,28519,,
2020-05-08T17:00:00,ITA,19,Sicilia,38.11569725,13.3623567,310,19,329,1798,2127,0,13,921,253,3301,98711,88497,,
2020-05-08T17:00:00,ITA,09,Toscana,43.76923077,11.25588885,399,84,483,4109,4592,-124,38,4199,930,9721,170296,126752,,
2020-05-08T17:00:00,ITA,04,P.A. Trento,46.06893511,11.12123097,94,11,105,767,872,-38,2,2975,438,4285,48220,29188,,
2020-05-08T17:00:00,ITA,10,Umbria,43.10675841,12.38824698,47,6,53,66,119,-22,1,1216,71,1406,44223,30704,,
2020-05-08T17:00:00,ITA,02,Valle d'Aosta,45.73750286,7.320149366,45,2,47,76,123,-7,1,889,139,1151,9280,6999,,
2020-05-08T17:00:00,ITA,05,Veneto,45.43490485,12.33845213,831,79,910,5277,6187,-347,65,10804,1627,18618,420949,240535,,
>>>>>>> upstream/master
=======
2020-05-09T17:00:00,ITA,13,Abruzzo,42.35122196,13.39843823,246,10,256,1420,1676,-37,8,1055,355,3086,47190,33013,,
2020-05-09T17:00:00,ITA,17,Basilicata,40.63947052,15.80514834,45,1,46,99,145,-7,0,210,27,382,17433,16941,,
2020-05-09T17:00:00,ITA,04,P.A. Bolzano,46.49933453,11.35662422,55,9,64,409,473,-29,9,1804,290,2567,48858,21969,,
2020-05-09T17:00:00,ITA,18,Calabria,38.90597598,16.59440194,68,2,70,542,612,-7,3,427,90,1129,45071,42993,,
2020-05-09T17:00:00,ITA,15,Campania,40.83956555,14.25084984,415,26,441,1524,1965,-47,14,2223,388,4576,110811,52593,,
2020-05-09T17:00:00,ITA,08,Emilia-Romagna,44.49436681,11.3417208,1604,155,1759,5642,7401,-329,121,15491,3827,26719,227366,146642,,
2020-05-09T17:00:00,ITA,06,Friuli Venezia Giulia,45.6494354,13.76813649,101,3,104,765,869,-42,8,1947,308,3124,88384,55319,,
2020-05-09T17:00:00,ITA,12,Lazio,41.89277044,12.48366722,1277,82,1359,2986,4345,17,47,2235,553,7133,174448,137428,,
2020-05-09T17:00:00,ITA,07,Liguria,44.41149315,8.9326992,501,42,543,2439,2982,-194,15,4480,1276,8738,64926,39600,,
2020-05-09T17:00:00,ITA,03,Lombardia,45.46679409,9.190347404,5535,330,5865,24397,30262,-1721,502,36039,14924,81225,477765,282817,,
2020-05-09T17:00:00,ITA,11,Marche,43.61675973,13.5188753,285,32,317,2913,3230,-8,23,2305,958,6493,73965,47827,,
2020-05-09T17:00:00,ITA,14,Molise,41.55774754,14.65916051,8,0,8,197,205,21,20,120,22,347,8691,8375,,
2020-05-09T17:00:00,ITA,01,Piemonte,45.0732745,7.680687483,2010,143,2153,11781,13934,-173,181,11284,3331,28549,205800,141515,,
2020-05-09T17:00:00,ITA,16,Puglia,41.12559576,16.86736689,344,33,377,2352,2729,-4,30,1114,443,4286,76643,54181,,
2020-05-09T17:00:00,ITA,20,Sardegna,39.21531192,9.110616306,87,11,98,452,550,-3,4,665,119,1334,33330,29503,,
2020-05-09T17:00:00,ITA,19,Sicilia,38.11569725,13.3623567,277,17,294,1786,2080,-47,12,977,256,3313,101548,90885,,
2020-05-09T17:00:00,ITA,09,Toscana,43.76923077,11.25588885,364,79,443,4005,4448,-144,24,4360,937,9745,174596,129382,,
2020-05-09T17:00:00,ITA,04,P.A. Trento,46.06893511,11.12123097,87,10,97,733,830,-42,7,3024,438,4292,50278,30354,,
2020-05-09T17:00:00,ITA,10,Umbria,43.10675841,12.38824698,45,6,51,60,111,-8,1,1225,71,1407,45574,31679,,
2020-05-09T17:00:00,ITA,02,Valle d'Aosta,45.73750286,7.320149366,45,3,48,70,118,-5,1,895,139,1152,9443,7130,,
2020-05-09T17:00:00,ITA,05,Veneto,45.43490485,12.33845213,435,40,475,5402,5877,-310,53,11151,1643,18671,432114,244930,,
>>>>>>> upstream/master
=======
2020-05-10T17:00:00,ITA,13,Abruzzo,42.35122196,13.39843823,233,10,243,1428,1671,-5,17,1073,359,3103,48110,33876,,
2020-05-10T17:00:00,ITA,17,Basilicata,40.63947052,15.80514834,45,1,46,97,143,-2,3,215,27,385,17916,17424,,
2020-05-10T17:00:00,ITA,04,P.A. Bolzano,46.49933453,11.35662422,61,8,69,390,459,-14,2,1820,290,2569,49571,22265,,
2020-05-10T17:00:00,ITA,18,Calabria,38.90597598,16.59440194,66,2,68,528,596,-16,3,445,91,1132,46111,44284,,
2020-05-10T17:00:00,ITA,15,Campania,40.83956555,14.25084984,435,20,455,1460,1915,-50,12,2282,391,4588,114819,53475,,
2020-05-10T17:00:00,ITA,08,Emilia-Romagna,44.49436681,11.3417208,1562,150,1712,5479,7191,-210,77,15760,3845,26796,231637,149276,,
2020-05-10T17:00:00,ITA,06,Friuli Venezia Giulia,45.6494354,13.76813649,98,3,101,750,851,-18,6,1969,310,3130,89449,56205,,
2020-05-10T17:00:00,ITA,12,Lazio,41.89277044,12.48366722,1265,84,1349,2937,4286,-59,32,2322,557,7165,178569,141233,,
2020-05-10T17:00:00,ITA,07,Liguria,44.41149315,8.9326992,481,41,522,2378,2900,-82,50,4607,1281,8788,67322,40751,,
2020-05-10T17:00:00,ITA,03,Lombardia,45.46679409,9.190347404,5428,348,5776,24414,30190,-72,282,36331,14986,81507,485134,287330,,
2020-05-10T17:00:00,ITA,11,Marche,43.61675973,13.5188753,284,30,314,2937,3251,21,40,2322,960,6533,76367,49194,,
2020-05-10T17:00:00,ITA,14,Molise,41.55774754,14.65916051,9,0,9,209,218,13,23,130,22,370,9164,9008,,
2020-05-10T17:00:00,ITA,01,Piemonte,45.0732745,7.680687483,2024,137,2161,11489,13650,-284,116,11648,3367,28665,210370,145131,,
2020-05-10T17:00:00,ITA,16,Puglia,41.12559576,16.86736689,343,34,377,2292,2669,-60,27,1196,448,4313,78399,54781,,
2020-05-10T17:00:00,ITA,20,Sardegna,39.21531192,9.110616306,83,10,93,422,515,-35,6,705,120,1340,34046,30086,,
2020-05-10T17:00:00,ITA,19,Sicilia,38.11569725,13.3623567,273,16,289,1780,2069,-11,14,1002,256,3327,102403,91748,,
2020-05-10T17:00:00,ITA,09,Toscana,43.76923077,11.25588885,350,78,428,3719,4147,-301,29,4685,942,9774,178208,131788,,
2020-05-10T17:00:00,ITA,04,P.A. Trento,46.06893511,11.12123097,82,10,92,694,786,-44,3,3068,441,4295,52039,30808,,
2020-05-10T17:00:00,ITA,10,Umbria,43.10675841,12.38824698,42,6,48,65,113,2,4,1227,71,1411,46923,32713,,
2020-05-10T17:00:00,ITA,02,Valle d'Aosta,45.73750286,7.320149366,46,2,48,65,113,-5,5,905,139,1157,9833,7467,,
2020-05-10T17:00:00,ITA,05,Veneto,45.43490485,12.33845213,408,37,445,5146,5591,-286,51,11474,1657,18722,439522,247617,,
>>>>>>> upstream/master
=======
2020-05-11T17:00:00,ITA,13,Abruzzo,42.35122196,13.39843823,231,9,240,1369,1609,-62,4,1132,366,3107,48903,34428,,
2020-05-11T17:00:00,ITA,17,Basilicata,40.63947052,15.80514834,46,1,47,95,142,-1,1,217,27,386,18266,17774,,
2020-05-11T17:00:00,ITA,04,P.A. Bolzano,46.49933453,11.35662422,63,7,70,377,447,-12,3,1835,290,2572,50019,22500,,
2020-05-11T17:00:00,ITA,18,Calabria,38.90597598,16.59440194,64,1,65,503,568,-28,2,473,93,1134,47265,45438,,
2020-05-11T17:00:00,ITA,15,Campania,40.83956555,14.25084984,436,23,459,1450,1909,-6,14,2301,392,4602,119042,54822,,
2020-05-11T17:00:00,ITA,08,Emilia-Romagna,44.49436681,11.3417208,1537,141,1678,5362,7040,-151,80,15969,3867,26876,234619,151040,,
2020-05-11T17:00:00,ITA,06,Friuli Venezia Giulia,45.6494354,13.76813649,96,3,99,731,830,-21,8,1996,312,3138,90860,57130,,
2020-05-11T17:00:00,ITA,12,Lazio,41.89277044,12.48366722,1266,83,1349,2945,4294,8,25,2334,562,7190,181398,143970,,
2020-05-11T17:00:00,ITA,07,Liguria,44.41149315,8.9326992,484,38,522,2322,2844,-56,44,4695,1293,8832,68814,41535,,
2020-05-11T17:00:00,ITA,03,Lombardia,45.46679409,9.190347404,5397,341,5738,24673,30411,221,364,36406,15054,81871,492642,292603,,
2020-05-11T17:00:00,ITA,11,Marche,43.61675973,13.5188753,277,28,305,2922,3227,-24,10,2352,964,6543,77830,50206,,
2020-05-11T17:00:00,ITA,14,Molise,41.55774754,14.65916051,11,0,11,218,229,11,13,132,22,383,9390,9247,,
2020-05-11T17:00:00,ITA,01,Piemonte,45.0732745,7.680687483,2021,135,2156,11182,13338,-312,111,12038,3400,28776,213783,147318,,
2020-05-11T17:00:00,ITA,16,Puglia,41.12559576,16.86736689,340,32,372,2172,2544,-125,14,1332,451,4327,79737,55794,,
2020-05-11T17:00:00,ITA,20,Sardegna,39.21531192,9.110616306,84,10,94,417,511,-4,3,712,120,1343,34641,30582,,
2020-05-11T17:00:00,ITA,19,Sicilia,38.11569725,13.3623567,271,16,287,1775,2062,-7,12,1020,257,3339,103134,92609,,
2020-05-11T17:00:00,ITA,09,Toscana,43.76923077,11.25588885,347,77,424,3649,4073,-74,13,4764,950,9787,179469,132464,,
2020-05-11T17:00:00,ITA,04,P.A. Trento,46.06893511,11.12123097,84,11,95,640,735,-51,2,3119,443,4297,53398,31970,,
2020-05-11T17:00:00,ITA,10,Umbria,43.10675841,12.38824698,40,4,44,64,108,-5,1,1233,71,1412,47474,33027,,
2020-05-11T17:00:00,ITA,02,Valle d'Aosta,45.73750286,7.320149366,44,1,45,62,107,-6,1,912,139,1158,10063,7651,,
2020-05-11T17:00:00,ITA,05,Veneto,45.43490485,12.33845213,400,38,438,5022,5460,-131,19,11615,1666,18741,445905,250175,,
>>>>>>> upstream/master
=======
2020-05-12T17:00:00,ITA,13,Abruzzo,42.35122196,13.39843823,222,8,230,1318,1548,-61,8,1197,370,3115,50295,35241,,
2020-05-12T17:00:00,ITA,17,Basilicata,40.63947052,15.80514834,47,1,48,92,140,-2,1,220,27,387,19100,18608,,
2020-05-12T17:00:00,ITA,04,P.A. Bolzano,46.49933453,11.35662422,56,7,63,374,437,-10,0,1845,290,2572,50381,22731,,
2020-05-12T17:00:00,ITA,18,Calabria,38.90597598,16.59440194,65,1,66,502,568,0,4,477,93,1138,48420,46593,,
2020-05-12T17:00:00,ITA,15,Campania,40.83956555,14.25084984,414,20,434,1443,1877,-32,13,2345,393,4615,121253,55406,,
2020-05-12T17:00:00,ITA,08,Emilia-Romagna,44.49436681,11.3417208,1384,136,1520,5281,6801,-239,53,16243,3885,26929,239178,153074,,
2020-05-12T17:00:00,ITA,06,Friuli Venezia Giulia,45.6494354,13.76813649,96,2,98,703,801,-29,10,2034,313,3148,93051,58395,,
2020-05-12T17:00:00,ITA,12,Lazio,41.89277044,12.48366722,1258,84,1342,2931,4273,-21,22,2373,566,7212,185085,147010,,
2020-05-12T17:00:00,ITA,07,Liguria,44.41149315,8.9326992,447,35,482,2297,2779,-65,31,4783,1301,8863,70159,42200,,
2020-05-12T17:00:00,ITA,03,Lombardia,45.46679409,9.190347404,5222,322,5544,25131,30675,264,1033,37113,15116,82904,513244,305152,dc-IT-0026,dc-EN-0026
2020-05-12T17:00:00,ITA,11,Marche,43.61675973,13.5188753,230,24,254,2954,3208,-19,25,2391,969,6568,79414,51176,,
2020-05-12T17:00:00,ITA,14,Molise,41.55774754,14.65916051,13,1,14,212,226,-3,3,138,22,386,9981,9582,,
2020-05-12T17:00:00,ITA,01,Piemonte,45.0732745,7.680687483,1900,136,2036,11148,13184,-154,113,12277,3428,28889,218071,149386,,
2020-05-12T17:00:00,ITA,16,Puglia,41.12559576,16.86736689,334,31,365,2056,2421,-123,10,1460,456,4337,81492,57060,,
2020-05-12T17:00:00,ITA,20,Sardegna,39.21531192,9.110616306,77,11,88,418,506,-5,1,718,120,1344,35476,31351,,
2020-05-12T17:00:00,ITA,19,Sicilia,38.11569725,13.3623567,234,15,249,1662,1911,-151,4,1171,261,3343,105017,94034,,
2020-05-12T17:00:00,ITA,09,Toscana,43.76923077,11.25588885,307,72,379,3462,3841,-232,15,5002,959,9802,184851,136285,,
2020-05-12T17:00:00,ITA,04,P.A. Trento,46.06893511,11.12123097,80,9,89,578,667,-68,6,3191,445,4303,55334,33082,,
2020-05-12T17:00:00,ITA,10,Umbria,43.10675841,12.38824698,41,4,45,64,109,1,7,1239,71,1419,49249,34207,,
2020-05-12T17:00:00,ITA,02,Valle d'Aosta,45.73750286,7.320149366,45,0,45,59,104,-3,2,916,140,1160,10415,7956,,
2020-05-12T17:00:00,ITA,05,Veneto,45.43490485,12.33845213,393,33,426,4764,5190,-270,41,11906,1686,18782,454189,253374,,
>>>>>>> upstream/master
=======
2020-05-13T17:00:00,ITA,13,Abruzzo,42.35122196,13.39843823,214,7,221,1268,1489,-59,12,1263,375,3127,51361,35898,,
2020-05-13T17:00:00,ITA,17,Basilicata,40.63947052,15.80514834,42,1,43,88,131,-9,2,231,27,389,19678,19186,,
2020-05-13T17:00:00,ITA,04,P.A. Bolzano,46.49933453,11.35662422,56,7,63,350,413,-24,3,1872,290,2575,51181,23120,,
2020-05-13T17:00:00,ITA,18,Calabria,38.90597598,16.59440194,64,1,65,486,551,-17,2,496,93,1140,49787,47960,,
2020-05-13T17:00:00,ITA,15,Campania,40.83956555,14.25084984,402,19,421,1394,1815,-62,15,2421,394,4630,124370,56390,,
2020-05-13T17:00:00,ITA,08,Emilia-Romagna,44.49436681,11.3417208,1165,123,1288,5214,6502,-299,50,16572,3905,26979,243883,155476,,
2020-05-13T17:00:00,ITA,06,Friuli Venezia Giulia,45.6494354,13.76813649,92,2,94,685,779,-22,8,2061,316,3156,94600,58936,,
2020-05-13T17:00:00,ITA,12,Lazio,41.89277044,12.48366722,1224,83,1307,2928,4235,-38,38,2438,577,7250,188632,150097,,
2020-05-13T17:00:00,ITA,07,Liguria,44.41149315,8.9326992,430,35,465,2253,2718,-61,67,4898,1314,8930,72174,43272,,
2020-05-13T17:00:00,ITA,03,Lombardia,45.46679409,9.190347404,5007,307,5314,24718,30032,-643,394,38081,15185,83298,524163,310896,,
2020-05-13T17:00:00,ITA,11,Marche,43.61675973,13.5188753,211,20,231,2782,3013,-195,20,2604,971,6588,80850,52041,,
2020-05-13T17:00:00,ITA,14,Molise,41.55774754,14.65916051,9,1,10,221,231,5,15,148,22,401,10062,9773,,
2020-05-13T17:00:00,ITA,01,Piemonte,45.0732745,7.680687483,1858,122,1980,10511,12491,-693,169,13107,3460,29058,224788,154504,,
2020-05-13T17:00:00,ITA,16,Puglia,41.12559576,16.86736689,310,27,337,1985,2322,-99,11,1566,460,4348,83713,58383,,
2020-05-13T17:00:00,ITA,20,Sardegna,39.21531192,9.110616306,78,10,88,403,491,-15,1,734,120,1345,36710,32449,,
2020-05-13T17:00:00,ITA,19,Sicilia,38.11569725,13.3623567,212,13,225,1664,1889,-22,11,1203,262,3354,107991,96860,,
2020-05-13T17:00:00,ITA,09,Toscana,43.76923077,11.25588885,284,72,356,3207,3563,-278,27,5302,964,9829,189026,138465,,
2020-05-13T17:00:00,ITA,04,P.A. Trento,46.06893511,11.12123097,76,9,85,488,573,-94,9,3293,446,4312,57997,34662,,
2020-05-13T17:00:00,ITA,10,Umbria,43.10675841,12.38824698,36,4,40,66,106,-3,0,1241,72,1419,50731,35313,,
2020-05-13T17:00:00,ITA,02,Valle d'Aosta,45.73750286,7.320149366,38,0,38,55,93,-11,3,929,141,1163,10777,8254,,
2020-05-13T17:00:00,ITA,05,Veneto,45.43490485,12.33845213,364,30,394,4626,5020,-170,31,12081,1712,18813,463154,257017,,
>>>>>>> upstream/master
=======
2020-05-14T17:00:00,ITA,13,Abruzzo,42.35122196,13.39843823,215,6,221,1261,1482,-7,9,1275,379,3136,52860,36844,,
2020-05-14T17:00:00,ITA,17,Basilicata,40.63947052,15.80514834,34,1,35,92,127,-4,0,235,27,389,20285,19789,,
2020-05-14T17:00:00,ITA,04,P.A. Bolzano,46.49933453,11.35662422,54,7,61,319,380,-33,3,1908,290,2578,52015,23487,,
2020-05-14T17:00:00,ITA,18,Calabria,38.90597598,16.59440194,59,2,61,463,524,-27,3,524,95,1143,51050,49196,,
2020-05-14T17:00:00,ITA,15,Campania,40.83956555,14.25084984,387,19,406,1359,1765,-50,9,2480,394,4639,127938,57684,,
2020-05-14T17:00:00,ITA,08,Emilia-Romagna,44.49436681,11.3417208,861,122,983,5318,6301,-201,77,16825,3930,27056,248591,158371,,
2020-05-14T17:00:00,ITA,06,Friuli Venezia Giulia,45.6494354,13.76813649,149,2,151,619,770,-9,5,2074,317,3161,97000,60177,,
2020-05-14T17:00:00,ITA,12,Lazio,41.89277044,12.48366722,1178,79,1257,2839,4096,-139,41,2600,595,7291,192917,153894,,
2020-05-14T17:00:00,ITA,07,Liguria,44.41149315,8.9326992,408,35,443,2217,2660,-58,65,5006,1329,8995,74248,44390,,
2020-05-14T17:00:00,ITA,03,Lombardia,45.46679409,9.190347404,4818,297,5115,24841,29956,-76,522,38568,15296,83820,538243,318289,,
2020-05-14T17:00:00,ITA,11,Marche,43.61675973,13.5188753,189,18,207,2697,2904,-109,15,2725,974,6603,82840,53030,,
2020-05-14T17:00:00,ITA,14,Molise,41.55774754,14.65916051,10,1,11,218,229,-2,2,152,22,403,10227,10052,,
2020-05-14T17:00:00,ITA,01,Piemonte,45.0732745,7.680687483,1775,116,1891,10000,11891,-600,151,13825,3493,29209,232682,158112,,
2020-05-14T17:00:00,ITA,16,Puglia,41.12559576,16.86736689,296,24,320,1933,2253,-69,9,1643,461,4357,85577,59815,,
2020-05-14T17:00:00,ITA,20,Sardegna,39.21531192,9.110616306,76,10,86,379,465,-26,0,755,125,1345,38034,33526,dc-IT-0028,dc-EN-0028
2020-05-14T17:00:00,ITA,19,Sicilia,38.11569725,13.3623567,203,12,215,1639,1854,-35,12,1249,263,3366,111137,99900,,
2020-05-14T17:00:00,ITA,09,Toscana,43.76923077,11.25588885,269,68,337,3051,3388,-175,30,5498,973,9859,193182,141430,,
2020-05-14T17:00:00,ITA,04,P.A. Trento,46.06893511,11.12123097,66,9,75,430,505,-68,3,3362,448,4315,60843,36359,,
2020-05-14T17:00:00,ITA,10,Umbria,43.10675841,12.38824698,26,1,27,65,92,-14,1,1255,73,1420,52247,36495,,
2020-05-14T17:00:00,ITA,02,Valle d'Aosta,45.73750286,7.320149366,38,0,38,42,80,-13,3,945,141,1166,11100,8537,,
2020-05-14T17:00:00,ITA,05,Veneto,45.43490485,12.33845213,342,26,368,4350,4718,-302,32,12384,1743,18845,474488,260706,,
>>>>>>> upstream/master
=======
2020-05-15T17:00:00,ITA,13,Abruzzo,42.35122196,13.39843823,205,6,211,1243,1454,-28,12,1313,381,3148,54028,37587,,
2020-05-15T17:00:00,ITA,17,Basilicata,40.63947052,15.80514834,33,1,34,86,120,-7,0,242,27,389,20851,20359,,
2020-05-15T17:00:00,ITA,21,P.A. Bolzano,46.49933453,11.35662422,50,5,55,304,359,-21,0,1929,290,2578,52939,23969,,
2020-05-15T17:00:00,ITA,18,Calabria,38.90597598,16.59440194,56,2,58,447,505,-19,1,544,95,1144,52701,50847,,
2020-05-15T17:00:00,ITA,15,Campania,40.83956555,14.25084984,341,17,358,1378,1736,-29,15,2522,396,4654,131544,59162,,
2020-05-15T17:00:00,ITA,08,Emilia-Romagna,44.49436681,11.3417208,763,114,877,5124,6001,-300,54,17166,3943,27110,253497,160622,,
2020-05-15T17:00:00,ITA,06,Friuli Venezia Giulia,45.6494354,13.76813649,80,3,83,658,741,-29,14,2116,318,3175,100400,62319,,
2020-05-15T17:00:00,ITA,12,Lazio,41.89277044,12.48366722,1173,79,1252,2836,4088,-8,73,2672,604,7364,197599,157880,dc-IT-0030,dc-EN-0030
2020-05-15T17:00:00,ITA,07,Liguria,44.41149315,8.9326992,385,31,416,2187,2603,-57,65,5121,1336,9060,76012,45307,,
2020-05-15T17:00:00,ITA,03,Lombardia,45.46679409,9.190347404,4705,276,4981,22765,27746,-2210,299,40962,15411,84119,550405,325071,,
2020-05-15T17:00:00,ITA,11,Marche,43.61675973,13.5188753,178,18,196,2599,2795,-109,16,2847,977,6619,84351,53813,,
2020-05-15T17:00:00,ITA,14,Molise,41.55774754,14.65916051,8,2,10,217,227,-2,4,158,22,407,10468,10281,,
2020-05-15T17:00:00,ITA,01,Piemonte,45.0732745,7.680687483,1593,108,1701,9412,11113,-778,137,14676,3557,29346,239507,161854,,
2020-05-15T17:00:00,ITA,16,Puglia,41.12559576,16.86736689,285,23,308,1873,2181,-72,9,1724,461,4366,87687,60613,,
2020-05-15T17:00:00,ITA,20,Sardegna,39.21531192,9.110616306,75,10,85,376,461,-4,3,762,125,1348,39844,34864,,
2020-05-15T17:00:00,ITA,19,Sicilia,38.11569725,13.3623567,198,11,209,1551,1760,-94,8,1351,263,3374,112929,101487,,
2020-05-15T17:00:00,ITA,09,Toscana,43.76923077,11.25588885,238,67,305,2863,3168,-220,24,5739,976,9883,197365,144237,,
2020-05-15T17:00:00,ITA,22,P.A. Trento,46.06893511,11.12123097,53,9,62,344,406,-99,3,3461,451,4318,63700,38273,,
2020-05-15T17:00:00,ITA,10,Umbria,43.10675841,12.38824698,25,2,27,63,90,-2,2,1259,73,1422,53801,37660,,
2020-05-15T17:00:00,ITA,02,Valle d'Aosta,45.73750286,7.320149366,37,0,37,40,77,-3,6,953,142,1172,11413,8814,,
2020-05-15T17:00:00,ITA,05,Veneto,45.43490485,12.33845213,311,24,335,4104,4439,-279,44,12688,1762,18889,484639,264091,,
>>>>>>> upstream/master
=======
2020-05-16T17:00:00,ITA,13,Abruzzo,42.35122196,13.39843823,195,7,202,1221,1423,-31,30,1372,383,3178,55672,38681,,
2020-05-16T17:00:00,ITA,17,Basilicata,40.63947052,15.80514834,29,1,30,83,113,-7,1,250,27,390,21496,20966,,
2020-05-16T17:00:00,ITA,21,P.A. Bolzano,46.49933453,11.35662422,48,5,53,290,343,-16,0,1945,290,2578,53703,24316,,
2020-05-16T17:00:00,ITA,18,Calabria,38.90597598,16.59440194,56,2,58,416,474,-31,7,582,95,1151,54091,52257,,
2020-05-16T17:00:00,ITA,15,Campania,40.83956555,14.25084984,351,16,367,1343,1710,-26,14,2562,396,4668,136261,61574,,
2020-05-16T17:00:00,ITA,08,Emilia-Romagna,44.49436681,11.3417208,740,112,852,5000,5852,-149,72,17370,3960,27182,258274,163067,,
2020-05-16T17:00:00,ITA,06,Friuli Venezia Giulia,45.6494354,13.76813649,79,3,82,598,680,-61,8,2184,319,3183,101694,63251,,
2020-05-16T17:00:00,ITA,12,Lazio,41.89277044,12.48366722,1156,76,1232,2790,4022,-66,32,2758,616,7396,201938,161405,,
2020-05-16T17:00:00,ITA,07,Liguria,44.41149315,8.9326992,369,26,395,2138,2533,-70,51,5232,1346,9111,78068,46304,,
2020-05-16T17:00:00,ITA,03,Lombardia,45.46679409,9.190347404,4521,268,4789,22890,27679,-67,399,41389,15450,84518,564550,333243,,
2020-05-16T17:00:00,ITA,11,Marche,43.61675973,13.5188753,154,17,171,2486,2657,-138,23,3003,982,6642,87211,54804,,
2020-05-16T17:00:00,ITA,14,Molise,41.55774754,14.65916051,8,2,10,205,215,-12,3,173,22,410,10859,10666,,
2020-05-16T17:00:00,ITA,01,Piemonte,45.0732745,7.680687483,1562,100,1662,9040,10702,-411,137,15187,3594,29483,245075,165849,,
2020-05-16T17:00:00,ITA,16,Puglia,41.12559576,16.86736689,272,22,294,1810,2104,-77,8,1807,463,4374,89611,61942,,
2020-05-16T17:00:00,ITA,20,Sardegna,39.21531192,9.110616306,75,10,85,330,415,-46,4,812,125,1352,41257,35933,,
2020-05-16T17:00:00,ITA,19,Sicilia,38.11569725,13.3623567,159,12,171,1488,1659,-101,8,1458,265,3382,114963,103103,,
2020-05-16T17:00:00,ITA,09,Toscana,43.76923077,11.25588885,234,66,300,2643,2943,-225,30,5991,979,9913,200703,145946,,
2020-05-16T17:00:00,ITA,22,P.A. Trento,46.06893511,11.12123097,44,8,52,293,345,-61,8,3528,453,4326,65383,39613,,
2020-05-16T17:00:00,ITA,10,Umbria,43.10675841,12.38824698,25,2,27,54,81,-9,0,1268,73,1422,55170,38663,,
2020-05-16T17:00:00,ITA,02,Valle d'Aosta,45.73750286,7.320149366,33,0,33,42,75,-2,1,956,142,1173,11835,9181,,
2020-05-16T17:00:00,ITA,05,Veneto,45.43490485,12.33845213,290,20,310,3852,4162,-277,39,12983,1783,18928,497045,269003,,
>>>>>>> upstream/master
=======
2020-05-17T17:00:00,ITA,13,Abruzzo,42.35122196,13.39843823,193,6,199,1223,1422,-1,8,1379,385,3186,57217,39788,,
2020-05-17T17:00:00,ITA,17,Basilicata,40.63947052,15.80514834,29,1,30,74,104,-9,2,261,27,392,22167,21627,,
2020-05-17T17:00:00,ITA,21,P.A. Bolzano,46.49933453,11.35662422,50,5,55,259,314,-29,3,1977,290,2581,54428,24677,,
2020-05-17T17:00:00,ITA,18,Calabria,38.90597598,16.59440194,56,2,58,364,422,-52,0,634,95,1151,55304,53470,,
2020-05-17T17:00:00,ITA,15,Campania,40.83956555,14.25084984,342,17,359,1337,1696,-14,16,2592,396,4684,139787,63039,,
2020-05-17T17:00:00,ITA,08,Emilia-Romagna,44.49436681,11.3417208,721,111,832,4824,5656,-196,50,17603,3973,27232,261106,163117,,
2020-05-17T17:00:00,ITA,06,Friuli Venezia Giulia,45.6494354,13.76813649,80,3,83,571,654,-26,8,2218,319,3191,104056,64558,,
2020-05-17T17:00:00,ITA,12,Lazio,41.89277044,12.48366722,1150,74,1224,2686,3910,-112,50,2914,622,7446,206166,164779,,
2020-05-17T17:00:00,ITA,07,Liguria,44.41149315,8.9326992,360,24,384,2072,2456,-77,48,5348,1355,9159,80154,47381,,
2020-05-17T17:00:00,ITA,03,Lombardia,45.46679409,9.190347404,4480,255,4735,22695,27430,-249,326,41895,15519,84844,576359,340164,,
2020-05-17T17:00:00,ITA,11,Marche,43.61675973,13.5188753,151,18,169,2396,2565,-92,25,3118,984,6667,88656,55667,,
2020-05-17T17:00:00,ITA,14,Molise,41.55774754,14.65916051,11,2,13,203,216,1,1,173,22,411,11085,10892,,
2020-05-17T17:00:00,ITA,01,Piemonte,45.0732745,7.680687483,1620,101,1721,8518,10239,-463,64,15696,3612,29547,249371,168295,,
2020-05-17T17:00:00,ITA,16,Puglia,41.12559576,16.86736689,263,21,284,1733,2017,-87,5,1892,470,4379,91035,62886,,
2020-05-17T17:00:00,ITA,20,Sardegna,39.21531192,9.110616306,76,10,86,319,405,-10,1,823,125,1353,42249,36736,,
2020-05-17T17:00:00,ITA,19,Sicilia,38.11569725,13.3623567,145,13,158,1397,1555,-104,6,1566,267,3388,117426,105074,,
2020-05-17T17:00:00,ITA,09,Toscana,43.76923077,11.25588885,214,67,281,2521,2802,-141,35,6162,984,9948,204022,148060,,
2020-05-17T17:00:00,ITA,22,P.A. Trento,46.06893511,11.12123097,41,8,49,252,301,-44,12,3584,453,4338,69659,41383,,
2020-05-17T17:00:00,ITA,10,Umbria,43.10675841,12.38824698,25,2,27,51,78,-3,2,1273,73,1424,55956,39272,,
2020-05-17T17:00:00,ITA,02,Valle d'Aosta,45.73750286,7.320149366,31,0,31,37,68,-7,0,962,143,1173,12169,9469,,
2020-05-17T17:00:00,ITA,05,Veneto,45.43490485,12.33845213,273,22,295,3746,4041,-121,13,13106,1794,18941,506588,272938,,
>>>>>>> upstream/master
