data,stato,codice_regione,denominazione_regione,lat,long,ricoverati_con_sintomi,terapia_intensiva,totale_ospedalizzati,isolamento_domiciliare,totale_positivi,variazione_totale_positivi,nuovi_positivi,dimessi_guariti,deceduti,totale_casi,tamponi,casi_testati,note_it,note_en
<<<<<<< HEAD
<<<<<<< HEAD
<<<<<<< HEAD
<<<<<<< HEAD
<<<<<<< HEAD
<<<<<<< HEAD
<<<<<<< HEAD
<<<<<<< HEAD
<<<<<<< HEAD
<<<<<<< HEAD
<<<<<<< HEAD
<<<<<<< HEAD
<<<<<<< HEAD
<<<<<<< HEAD
<<<<<<< HEAD
<<<<<<< HEAD
<<<<<<< HEAD
<<<<<<< HEAD
<<<<<<< HEAD
<<<<<<< HEAD
<<<<<<< HEAD
<<<<<<< HEAD
<<<<<<< HEAD
<<<<<<< HEAD
<<<<<<< HEAD
<<<<<<< HEAD
2020-05-05T17:00:00,ITA,13,Abruzzo,42.35122196,13.39843823,289,11,300,1509,1809,-28,25,881,335,3025,42489,30835,,
2020-05-05T17:00:00,ITA,17,Basilicata,40.63947052,15.80514834,50,3,53,124,177,4,10,194,25,396,15476,15028,,
2020-05-05T17:00:00,ITA,04,P.A. Bolzano,46.49933453,11.35662422,99,11,110,502,612,-24,1,1644,286,2542,45264,20561,,
2020-05-05T17:00:00,ITA,18,Calabria,38.90597598,16.59440194,92,4,96,554,650,-24,1,381,88,1119,40509,38461,,
2020-05-05T17:00:00,ITA,15,Campania,40.83956555,14.25084984,408,25,433,2097,2530,-181,20,1619,369,4518,93068,48733,,
2020-05-05T17:00:00,ITA,08,Emilia-Romagna,44.49436681,11.3417208,1917,191,2108,6573,8681,-303,100,13889,3705,26275,206166,136310,,
2020-05-05T17:00:00,ITA,06,Friuli Venezia Giulia,45.6494354,13.76813649,120,4,124,860,984,-66,9,1798,303,3085,78510,50135,,
2020-05-05T17:00:00,ITA,12,Lazio,41.89277044,12.48366722,1315,91,1406,2964,4370,-15,67,2010,534,6914,157307,122541,,
2020-05-05T17:00:00,ITA,07,Liguria,44.41149315,8.9326992,583,68,651,2776,3427,-81,63,3816,1232,8475,57622,36150,,
2020-05-05T17:00:00,ITA,03,Lombardia,45.46679409,9.190347404,6201,509,6710,30382,37092,-215,500,27124,14389,78605,425290,255292,,
2020-05-05T17:00:00,ITA,11,Marche,43.61675973,13.5188753,387,42,429,2790,3219,13,29,2237,936,6392,67256,44045,,
2020-05-05T17:00:00,ITA,14,Molise,41.55774754,14.65916051,9,1,10,167,177,-1,0,102,22,301,7528,7252,,
2020-05-05T17:00:00,ITA,01,Piemonte,45.0732745,7.680687483,2307,155,2462,12861,15323,-239,152,9235,3216,27774,181316,126685,,
2020-05-05T17:00:00,ITA,16,Puglia,41.12559576,16.86736689,384,39,423,2516,2939,-6,17,798,433,4170,69128,67238,,
2020-05-05T17:00:00,ITA,20,Sardegna,39.21531192,9.110616306,94,9,103,539,642,-11,1,557,119,1318,28867,25631,,
2020-05-05T17:00:00,ITA,19,Sicilia,38.11569725,13.3623567,367,26,393,1809,2202,0,12,818,247,3267,91306,82079,,
2020-05-05T17:00:00,ITA,09,Toscana,43.76923077,11.25588885,484,111,595,4595,5190,-89,30,3552,889,9631,157260,118265,,
2020-05-05T17:00:00,ITA,04,P.A. Trento,46.06893511,11.12123097,126,15,141,900,1041,-124,3,2787,433,4261,42870,25137,,
2020-05-05T17:00:00,ITA,10,Umbria,43.10675841,12.38824698,56,11,67,109,176,-5,6,1154,70,1400,39998,27822,,
2020-05-05T17:00:00,ITA,02,Valle d'Aosta,45.73750286,7.320149366,56,3,59,51,110,0,0,894,139,1143,8484,6342,,
2020-05-05T17:00:00,ITA,05,Veneto,45.43490485,12.33845213,926,98,1024,6092,7116,-118,29,9741,1545,18402,390952,227579,,
=======
2020-05-06T17:00:00,ITA,13,Abruzzo,42.35122196,13.39843823,285,11,296,1495,1791,-18,22,915,341,3047,43803,31502,,
2020-05-06T17:00:00,ITA,17,Basilicata,40.63947052,15.80514834,47,3,50,122,172,-5,3,202,25,399,16103,15619,,
2020-05-06T17:00:00,ITA,04,P.A. Bolzano,46.49933453,11.35662422,99,11,110,469,579,-33,1,1678,286,2543,46228,20872,,
2020-05-06T17:00:00,ITA,18,Calabria,38.90597598,16.59440194,87,3,90,554,644,-6,3,389,89,1122,41828,39780,,
2020-05-06T17:00:00,ITA,15,Campania,40.83956555,14.25084984,433,25,458,1882,2340,-190,14,1816,376,4532,96548,49478,,
2020-05-06T17:00:00,ITA,08,Emilia-Romagna,44.49436681,11.3417208,1816,176,1992,6399,8391,-290,104,14251,3737,26379,211652,138871,,
2020-05-06T17:00:00,ITA,06,Friuli Venezia Giulia,45.6494354,13.76813649,115,3,118,844,962,-22,9,1826,306,3094,79429,50698,,
2020-05-06T17:00:00,ITA,12,Lazio,41.89277044,12.48366722,1351,91,1442,2991,4433,63,81,2024,538,6995,160894,125897,,
2020-05-06T17:00:00,ITA,07,Liguria,44.41149315,8.9326992,548,59,607,2699,3306,-121,76,4002,1243,8551,59693,37177,,
2020-05-06T17:00:00,ITA,03,Lombardia,45.46679409,9.190347404,6079,480,6559,25194,31753,-5339,764,33005,14611,79369,439806,262964,dc-IT-0020,dc-EN-0020
2020-05-06T17:00:00,ITA,11,Marche,43.61675973,13.5188753,353,42,395,2841,3236,17,29,2242,943,6421,69037,45026,,
2020-05-06T17:00:00,ITA,14,Molise,41.55774754,14.65916051,9,0,9,170,179,2,3,103,22,304,7896,7604,,
2020-05-06T17:00:00,ITA,01,Piemonte,45.0732745,7.680687483,2147,150,2297,12561,14858,-465,165,9834,3247,27939,188057,131269,,
2020-05-06T17:00:00,ITA,16,Puglia,41.12559576,16.86736689,365,36,401,2502,2903,-36,26,855,438,4196,70944,68760,,
2020-05-06T17:00:00,ITA,20,Sardegna,39.21531192,9.110616306,91,11,102,521,623,-19,1,577,119,1319,29966,26598,,
2020-05-06T17:00:00,ITA,19,Sicilia,38.11569725,13.3623567,359,25,384,1817,2201,-1,14,830,250,3281,92999,83908,,
2020-05-06T17:00:00,ITA,09,Toscana,43.76923077,11.25588885,462,92,554,4534,5088,-102,26,3670,899,9657,161553,121066,,
2020-05-06T17:00:00,ITA,04,P.A. Trento,46.06893511,11.12123097,116,13,129,853,982,-59,19,2861,437,4280,44719,26161,,
2020-05-06T17:00:00,ITA,10,Umbria,43.10675841,12.38824698,55,9,64,107,171,-5,4,1163,70,1404,41328,28712,,
2020-05-06T17:00:00,ITA,02,Valle d'Aosta,45.73750286,7.320149366,50,3,53,74,127,17,3,880,139,1146,8640,6461,,
2020-05-06T17:00:00,ITA,05,Veneto,45.43490485,12.33845213,902,90,992,5797,6789,-327,77,10122,1568,18479,399806,231469,,
>>>>>>> upstream/master
=======
2020-05-07T17:00:00,ITA,13,Abruzzo,42.35122196,13.39843823,263,12,275,1495,1770,-21,25,954,348,3072,45021,32186,,
2020-05-07T17:00:00,ITA,17,Basilicata,40.63947052,15.80514834,48,2,50,105,155,-17,-16,202,26,383,16272,15780,dc-IT-0022,dc-EN-0022
2020-05-07T17:00:00,ITA,04,P.A. Bolzano,46.49933453,11.35662422,87,11,98,453,551,-28,9,1715,286,2552,47091,21284,,
2020-05-07T17:00:00,ITA,18,Calabria,38.90597598,16.59440194,81,2,83,550,633,-11,3,403,89,1125,42854,40806,,
2020-05-07T17:00:00,ITA,15,Campania,40.83956555,14.25084984,415,27,442,1697,2139,-201,9,2023,379,4541,101025,50463,,
2020-05-07T17:00:00,ITA,08,Emilia-Romagna,44.49436681,11.3417208,1726,173,1899,6112,8011,-380,108,14710,3766,26487,217039,141468,,
2020-05-07T17:00:00,ITA,06,Friuli Venezia Giulia,45.6494354,13.76813649,109,2,111,816,927,-35,13,1872,308,3107,82012,51123,,
2020-05-07T17:00:00,ITA,12,Lazio,41.89277044,12.48366722,1291,89,1380,2968,4348,-85,39,2143,543,7034,165340,130351,,
2020-05-07T17:00:00,ITA,07,Liguria,44.41149315,8.9326992,525,57,582,2666,3248,-58,94,4143,1254,8645,61446,38071,,
2020-05-07T17:00:00,ITA,03,Lombardia,45.46679409,9.190347404,5848,480,6328,25687,32015,262,720,33329,14745,80089,455294,262964,,
2020-05-07T17:00:00,ITA,11,Marche,43.61675973,13.5188753,328,41,369,2878,3247,11,31,2257,948,6452,71017,46258,,
2020-05-07T17:00:00,ITA,14,Molise,41.55774754,14.65916051,8,0,8,162,170,-9,1,113,22,305,8237,7912,,
2020-05-07T17:00:00,ITA,01,Piemonte,45.0732745,7.680687483,2147,150,2297,12172,14469,-389,196,10384,3282,28135,194584,134567,,
2020-05-07T17:00:00,ITA,16,Puglia,41.12559576,16.86736689,355,35,390,2410,2800,-103,49,1004,441,4245,72796,51638,,
2020-05-07T17:00:00,ITA,20,Sardegna,39.21531192,9.110616306,90,9,99,484,583,-40,5,622,119,1324,31064,27540,,
2020-05-07T17:00:00,ITA,19,Sicilia,38.11569725,13.3623567,349,21,370,1757,2127,-74,7,910,251,3288,95695,85674,,
2020-05-07T17:00:00,ITA,09,Toscana,43.76923077,11.25588885,437,91,528,4188,4716,-372,26,4052,915,9683,166062,124295,,
2020-05-07T17:00:00,ITA,04,P.A. Trento,46.06893511,11.12123097,99,11,110,800,910,-72,3,2935,438,4283,46500,28486,,
2020-05-07T17:00:00,ITA,10,Umbria,43.10675841,12.38824698,47,9,56,85,141,-30,1,1194,70,1405,42788,29708,,
2020-05-07T17:00:00,ITA,02,Valle d'Aosta,45.73750286,7.320149366,49,2,51,79,130,3,4,881,139,1150,8939,6702,,
2020-05-07T17:00:00,ITA,05,Veneto,45.43490485,12.33845213,872,87,959,5575,6534,-255,74,10430,1589,18553,410212,236281,,
>>>>>>> upstream/master
=======
2020-05-08T17:00:00,ITA,13,Abruzzo,42.35122196,13.39843823,250,10,260,1453,1713,-57,6,1014,351,3078,46103,32619,,
2020-05-08T17:00:00,ITA,17,Basilicata,40.63947052,15.80514834,48,2,50,102,152,-3,-1,204,26,382,16777,16285,dc-IT-0024,dc-EN-0024
2020-05-08T17:00:00,ITA,04,P.A. Bolzano,46.49933453,11.35662422,78,9,87,415,502,-49,6,1767,289,2558,47908,21572,,
2020-05-08T17:00:00,ITA,18,Calabria,38.90597598,16.59440194,73,2,75,544,619,-14,1,417,90,1126,43980,41902,,
2020-05-08T17:00:00,ITA,15,Campania,40.83956555,14.25084984,418,28,446,1566,2012,-127,21,2164,386,4562,105399,51402,,
2020-05-08T17:00:00,ITA,08,Emilia-Romagna,44.49436681,11.3417208,1680,163,1843,5887,7730,-281,111,15071,3797,26598,221866,144009,,
2020-05-08T17:00:00,ITA,06,Friuli Venezia Giulia,45.6494354,13.76813649,105,2,107,804,911,-16,9,1897,308,3116,82902,52784,,
2020-05-08T17:00:00,ITA,12,Lazio,41.89277044,12.48366722,1278,84,1362,2966,4328,-20,52,2209,549,7086,169499,133674,,
2020-05-08T17:00:00,ITA,07,Liguria,44.41149315,8.9326992,517,46,563,2613,3176,-72,78,4282,1265,8723,63531,39145,,
2020-05-08T17:00:00,ITA,03,Lombardia,45.46679409,9.190347404,5702,400,6102,25881,31983,-32,634,33901,14839,80723,466287,277106,,
2020-05-08T17:00:00,ITA,11,Marche,43.61675973,13.5188753,303,38,341,2897,3238,-9,18,2278,954,6470,72504,47092,,
2020-05-08T17:00:00,ITA,14,Molise,41.55774754,14.65916051,6,0,6,178,184,14,22,121,22,327,8502,8177,,
2020-05-08T17:00:00,ITA,01,Piemonte,45.0732745,7.680687483,2013,140,2153,11954,14107,-362,233,10956,3305,28368,201183,138830,,
2020-05-08T17:00:00,ITA,16,Puglia,41.12559576,16.86736689,349,33,382,2351,2733,-67,11,1080,443,4256,74724,53194,,
2020-05-08T17:00:00,ITA,20,Sardegna,39.21531192,9.110616306,90,10,100,453,553,-30,6,658,119,1330,32219,28519,,
2020-05-08T17:00:00,ITA,19,Sicilia,38.11569725,13.3623567,310,19,329,1798,2127,0,13,921,253,3301,98711,88497,,
2020-05-08T17:00:00,ITA,09,Toscana,43.76923077,11.25588885,399,84,483,4109,4592,-124,38,4199,930,9721,170296,126752,,
2020-05-08T17:00:00,ITA,04,P.A. Trento,46.06893511,11.12123097,94,11,105,767,872,-38,2,2975,438,4285,48220,29188,,
2020-05-08T17:00:00,ITA,10,Umbria,43.10675841,12.38824698,47,6,53,66,119,-22,1,1216,71,1406,44223,30704,,
2020-05-08T17:00:00,ITA,02,Valle d'Aosta,45.73750286,7.320149366,45,2,47,76,123,-7,1,889,139,1151,9280,6999,,
2020-05-08T17:00:00,ITA,05,Veneto,45.43490485,12.33845213,831,79,910,5277,6187,-347,65,10804,1627,18618,420949,240535,,
>>>>>>> upstream/master
=======
2020-05-09T17:00:00,ITA,13,Abruzzo,42.35122196,13.39843823,246,10,256,1420,1676,-37,8,1055,355,3086,47190,33013,,
2020-05-09T17:00:00,ITA,17,Basilicata,40.63947052,15.80514834,45,1,46,99,145,-7,0,210,27,382,17433,16941,,
2020-05-09T17:00:00,ITA,04,P.A. Bolzano,46.49933453,11.35662422,55,9,64,409,473,-29,9,1804,290,2567,48858,21969,,
2020-05-09T17:00:00,ITA,18,Calabria,38.90597598,16.59440194,68,2,70,542,612,-7,3,427,90,1129,45071,42993,,
2020-05-09T17:00:00,ITA,15,Campania,40.83956555,14.25084984,415,26,441,1524,1965,-47,14,2223,388,4576,110811,52593,,
2020-05-09T17:00:00,ITA,08,Emilia-Romagna,44.49436681,11.3417208,1604,155,1759,5642,7401,-329,121,15491,3827,26719,227366,146642,,
2020-05-09T17:00:00,ITA,06,Friuli Venezia Giulia,45.6494354,13.76813649,101,3,104,765,869,-42,8,1947,308,3124,88384,55319,,
2020-05-09T17:00:00,ITA,12,Lazio,41.89277044,12.48366722,1277,82,1359,2986,4345,17,47,2235,553,7133,174448,137428,,
2020-05-09T17:00:00,ITA,07,Liguria,44.41149315,8.9326992,501,42,543,2439,2982,-194,15,4480,1276,8738,64926,39600,,
2020-05-09T17:00:00,ITA,03,Lombardia,45.46679409,9.190347404,5535,330,5865,24397,30262,-1721,502,36039,14924,81225,477765,282817,,
2020-05-09T17:00:00,ITA,11,Marche,43.61675973,13.5188753,285,32,317,2913,3230,-8,23,2305,958,6493,73965,47827,,
2020-05-09T17:00:00,ITA,14,Molise,41.55774754,14.65916051,8,0,8,197,205,21,20,120,22,347,8691,8375,,
2020-05-09T17:00:00,ITA,01,Piemonte,45.0732745,7.680687483,2010,143,2153,11781,13934,-173,181,11284,3331,28549,205800,141515,,
2020-05-09T17:00:00,ITA,16,Puglia,41.12559576,16.86736689,344,33,377,2352,2729,-4,30,1114,443,4286,76643,54181,,
2020-05-09T17:00:00,ITA,20,Sardegna,39.21531192,9.110616306,87,11,98,452,550,-3,4,665,119,1334,33330,29503,,
2020-05-09T17:00:00,ITA,19,Sicilia,38.11569725,13.3623567,277,17,294,1786,2080,-47,12,977,256,3313,101548,90885,,
2020-05-09T17:00:00,ITA,09,Toscana,43.76923077,11.25588885,364,79,443,4005,4448,-144,24,4360,937,9745,174596,129382,,
2020-05-09T17:00:00,ITA,04,P.A. Trento,46.06893511,11.12123097,87,10,97,733,830,-42,7,3024,438,4292,50278,30354,,
2020-05-09T17:00:00,ITA,10,Umbria,43.10675841,12.38824698,45,6,51,60,111,-8,1,1225,71,1407,45574,31679,,
2020-05-09T17:00:00,ITA,02,Valle d'Aosta,45.73750286,7.320149366,45,3,48,70,118,-5,1,895,139,1152,9443,7130,,
2020-05-09T17:00:00,ITA,05,Veneto,45.43490485,12.33845213,435,40,475,5402,5877,-310,53,11151,1643,18671,432114,244930,,
>>>>>>> upstream/master
=======
2020-05-10T17:00:00,ITA,13,Abruzzo,42.35122196,13.39843823,233,10,243,1428,1671,-5,17,1073,359,3103,48110,33876,,
2020-05-10T17:00:00,ITA,17,Basilicata,40.63947052,15.80514834,45,1,46,97,143,-2,3,215,27,385,17916,17424,,
2020-05-10T17:00:00,ITA,04,P.A. Bolzano,46.49933453,11.35662422,61,8,69,390,459,-14,2,1820,290,2569,49571,22265,,
2020-05-10T17:00:00,ITA,18,Calabria,38.90597598,16.59440194,66,2,68,528,596,-16,3,445,91,1132,46111,44284,,
2020-05-10T17:00:00,ITA,15,Campania,40.83956555,14.25084984,435,20,455,1460,1915,-50,12,2282,391,4588,114819,53475,,
2020-05-10T17:00:00,ITA,08,Emilia-Romagna,44.49436681,11.3417208,1562,150,1712,5479,7191,-210,77,15760,3845,26796,231637,149276,,
2020-05-10T17:00:00,ITA,06,Friuli Venezia Giulia,45.6494354,13.76813649,98,3,101,750,851,-18,6,1969,310,3130,89449,56205,,
2020-05-10T17:00:00,ITA,12,Lazio,41.89277044,12.48366722,1265,84,1349,2937,4286,-59,32,2322,557,7165,178569,141233,,
2020-05-10T17:00:00,ITA,07,Liguria,44.41149315,8.9326992,481,41,522,2378,2900,-82,50,4607,1281,8788,67322,40751,,
2020-05-10T17:00:00,ITA,03,Lombardia,45.46679409,9.190347404,5428,348,5776,24414,30190,-72,282,36331,14986,81507,485134,287330,,
2020-05-10T17:00:00,ITA,11,Marche,43.61675973,13.5188753,284,30,314,2937,3251,21,40,2322,960,6533,76367,49194,,
2020-05-10T17:00:00,ITA,14,Molise,41.55774754,14.65916051,9,0,9,209,218,13,23,130,22,370,9164,9008,,
2020-05-10T17:00:00,ITA,01,Piemonte,45.0732745,7.680687483,2024,137,2161,11489,13650,-284,116,11648,3367,28665,210370,145131,,
2020-05-10T17:00:00,ITA,16,Puglia,41.12559576,16.86736689,343,34,377,2292,2669,-60,27,1196,448,4313,78399,54781,,
2020-05-10T17:00:00,ITA,20,Sardegna,39.21531192,9.110616306,83,10,93,422,515,-35,6,705,120,1340,34046,30086,,
2020-05-10T17:00:00,ITA,19,Sicilia,38.11569725,13.3623567,273,16,289,1780,2069,-11,14,1002,256,3327,102403,91748,,
2020-05-10T17:00:00,ITA,09,Toscana,43.76923077,11.25588885,350,78,428,3719,4147,-301,29,4685,942,9774,178208,131788,,
2020-05-10T17:00:00,ITA,04,P.A. Trento,46.06893511,11.12123097,82,10,92,694,786,-44,3,3068,441,4295,52039,30808,,
2020-05-10T17:00:00,ITA,10,Umbria,43.10675841,12.38824698,42,6,48,65,113,2,4,1227,71,1411,46923,32713,,
2020-05-10T17:00:00,ITA,02,Valle d'Aosta,45.73750286,7.320149366,46,2,48,65,113,-5,5,905,139,1157,9833,7467,,
2020-05-10T17:00:00,ITA,05,Veneto,45.43490485,12.33845213,408,37,445,5146,5591,-286,51,11474,1657,18722,439522,247617,,
>>>>>>> upstream/master
=======
2020-05-11T17:00:00,ITA,13,Abruzzo,42.35122196,13.39843823,231,9,240,1369,1609,-62,4,1132,366,3107,48903,34428,,
2020-05-11T17:00:00,ITA,17,Basilicata,40.63947052,15.80514834,46,1,47,95,142,-1,1,217,27,386,18266,17774,,
2020-05-11T17:00:00,ITA,04,P.A. Bolzano,46.49933453,11.35662422,63,7,70,377,447,-12,3,1835,290,2572,50019,22500,,
2020-05-11T17:00:00,ITA,18,Calabria,38.90597598,16.59440194,64,1,65,503,568,-28,2,473,93,1134,47265,45438,,
2020-05-11T17:00:00,ITA,15,Campania,40.83956555,14.25084984,436,23,459,1450,1909,-6,14,2301,392,4602,119042,54822,,
2020-05-11T17:00:00,ITA,08,Emilia-Romagna,44.49436681,11.3417208,1537,141,1678,5362,7040,-151,80,15969,3867,26876,234619,151040,,
2020-05-11T17:00:00,ITA,06,Friuli Venezia Giulia,45.6494354,13.76813649,96,3,99,731,830,-21,8,1996,312,3138,90860,57130,,
2020-05-11T17:00:00,ITA,12,Lazio,41.89277044,12.48366722,1266,83,1349,2945,4294,8,25,2334,562,7190,181398,143970,,
2020-05-11T17:00:00,ITA,07,Liguria,44.41149315,8.9326992,484,38,522,2322,2844,-56,44,4695,1293,8832,68814,41535,,
2020-05-11T17:00:00,ITA,03,Lombardia,45.46679409,9.190347404,5397,341,5738,24673,30411,221,364,36406,15054,81871,492642,292603,,
2020-05-11T17:00:00,ITA,11,Marche,43.61675973,13.5188753,277,28,305,2922,3227,-24,10,2352,964,6543,77830,50206,,
2020-05-11T17:00:00,ITA,14,Molise,41.55774754,14.65916051,11,0,11,218,229,11,13,132,22,383,9390,9247,,
2020-05-11T17:00:00,ITA,01,Piemonte,45.0732745,7.680687483,2021,135,2156,11182,13338,-312,111,12038,3400,28776,213783,147318,,
2020-05-11T17:00:00,ITA,16,Puglia,41.12559576,16.86736689,340,32,372,2172,2544,-125,14,1332,451,4327,79737,55794,,
2020-05-11T17:00:00,ITA,20,Sardegna,39.21531192,9.110616306,84,10,94,417,511,-4,3,712,120,1343,34641,30582,,
2020-05-11T17:00:00,ITA,19,Sicilia,38.11569725,13.3623567,271,16,287,1775,2062,-7,12,1020,257,3339,103134,92609,,
2020-05-11T17:00:00,ITA,09,Toscana,43.76923077,11.25588885,347,77,424,3649,4073,-74,13,4764,950,9787,179469,132464,,
2020-05-11T17:00:00,ITA,04,P.A. Trento,46.06893511,11.12123097,84,11,95,640,735,-51,2,3119,443,4297,53398,31970,,
2020-05-11T17:00:00,ITA,10,Umbria,43.10675841,12.38824698,40,4,44,64,108,-5,1,1233,71,1412,47474,33027,,
2020-05-11T17:00:00,ITA,02,Valle d'Aosta,45.73750286,7.320149366,44,1,45,62,107,-6,1,912,139,1158,10063,7651,,
2020-05-11T17:00:00,ITA,05,Veneto,45.43490485,12.33845213,400,38,438,5022,5460,-131,19,11615,1666,18741,445905,250175,,
>>>>>>> upstream/master
=======
2020-05-12T17:00:00,ITA,13,Abruzzo,42.35122196,13.39843823,222,8,230,1318,1548,-61,8,1197,370,3115,50295,35241,,
2020-05-12T17:00:00,ITA,17,Basilicata,40.63947052,15.80514834,47,1,48,92,140,-2,1,220,27,387,19100,18608,,
2020-05-12T17:00:00,ITA,04,P.A. Bolzano,46.49933453,11.35662422,56,7,63,374,437,-10,0,1845,290,2572,50381,22731,,
2020-05-12T17:00:00,ITA,18,Calabria,38.90597598,16.59440194,65,1,66,502,568,0,4,477,93,1138,48420,46593,,
2020-05-12T17:00:00,ITA,15,Campania,40.83956555,14.25084984,414,20,434,1443,1877,-32,13,2345,393,4615,121253,55406,,
2020-05-12T17:00:00,ITA,08,Emilia-Romagna,44.49436681,11.3417208,1384,136,1520,5281,6801,-239,53,16243,3885,26929,239178,153074,,
2020-05-12T17:00:00,ITA,06,Friuli Venezia Giulia,45.6494354,13.76813649,96,2,98,703,801,-29,10,2034,313,3148,93051,58395,,
2020-05-12T17:00:00,ITA,12,Lazio,41.89277044,12.48366722,1258,84,1342,2931,4273,-21,22,2373,566,7212,185085,147010,,
2020-05-12T17:00:00,ITA,07,Liguria,44.41149315,8.9326992,447,35,482,2297,2779,-65,31,4783,1301,8863,70159,42200,,
2020-05-12T17:00:00,ITA,03,Lombardia,45.46679409,9.190347404,5222,322,5544,25131,30675,264,1033,37113,15116,82904,513244,305152,dc-IT-0026,dc-EN-0026
2020-05-12T17:00:00,ITA,11,Marche,43.61675973,13.5188753,230,24,254,2954,3208,-19,25,2391,969,6568,79414,51176,,
2020-05-12T17:00:00,ITA,14,Molise,41.55774754,14.65916051,13,1,14,212,226,-3,3,138,22,386,9981,9582,,
2020-05-12T17:00:00,ITA,01,Piemonte,45.0732745,7.680687483,1900,136,2036,11148,13184,-154,113,12277,3428,28889,218071,149386,,
2020-05-12T17:00:00,ITA,16,Puglia,41.12559576,16.86736689,334,31,365,2056,2421,-123,10,1460,456,4337,81492,57060,,
2020-05-12T17:00:00,ITA,20,Sardegna,39.21531192,9.110616306,77,11,88,418,506,-5,1,718,120,1344,35476,31351,,
2020-05-12T17:00:00,ITA,19,Sicilia,38.11569725,13.3623567,234,15,249,1662,1911,-151,4,1171,261,3343,105017,94034,,
2020-05-12T17:00:00,ITA,09,Toscana,43.76923077,11.25588885,307,72,379,3462,3841,-232,15,5002,959,9802,184851,136285,,
2020-05-12T17:00:00,ITA,04,P.A. Trento,46.06893511,11.12123097,80,9,89,578,667,-68,6,3191,445,4303,55334,33082,,
2020-05-12T17:00:00,ITA,10,Umbria,43.10675841,12.38824698,41,4,45,64,109,1,7,1239,71,1419,49249,34207,,
2020-05-12T17:00:00,ITA,02,Valle d'Aosta,45.73750286,7.320149366,45,0,45,59,104,-3,2,916,140,1160,10415,7956,,
2020-05-12T17:00:00,ITA,05,Veneto,45.43490485,12.33845213,393,33,426,4764,5190,-270,41,11906,1686,18782,454189,253374,,
>>>>>>> upstream/master
=======
2020-05-13T17:00:00,ITA,13,Abruzzo,42.35122196,13.39843823,214,7,221,1268,1489,-59,12,1263,375,3127,51361,35898,,
2020-05-13T17:00:00,ITA,17,Basilicata,40.63947052,15.80514834,42,1,43,88,131,-9,2,231,27,389,19678,19186,,
2020-05-13T17:00:00,ITA,04,P.A. Bolzano,46.49933453,11.35662422,56,7,63,350,413,-24,3,1872,290,2575,51181,23120,,
2020-05-13T17:00:00,ITA,18,Calabria,38.90597598,16.59440194,64,1,65,486,551,-17,2,496,93,1140,49787,47960,,
2020-05-13T17:00:00,ITA,15,Campania,40.83956555,14.25084984,402,19,421,1394,1815,-62,15,2421,394,4630,124370,56390,,
2020-05-13T17:00:00,ITA,08,Emilia-Romagna,44.49436681,11.3417208,1165,123,1288,5214,6502,-299,50,16572,3905,26979,243883,155476,,
2020-05-13T17:00:00,ITA,06,Friuli Venezia Giulia,45.6494354,13.76813649,92,2,94,685,779,-22,8,2061,316,3156,94600,58936,,
2020-05-13T17:00:00,ITA,12,Lazio,41.89277044,12.48366722,1224,83,1307,2928,4235,-38,38,2438,577,7250,188632,150097,,
2020-05-13T17:00:00,ITA,07,Liguria,44.41149315,8.9326992,430,35,465,2253,2718,-61,67,4898,1314,8930,72174,43272,,
2020-05-13T17:00:00,ITA,03,Lombardia,45.46679409,9.190347404,5007,307,5314,24718,30032,-643,394,38081,15185,83298,524163,310896,,
2020-05-13T17:00:00,ITA,11,Marche,43.61675973,13.5188753,211,20,231,2782,3013,-195,20,2604,971,6588,80850,52041,,
2020-05-13T17:00:00,ITA,14,Molise,41.55774754,14.65916051,9,1,10,221,231,5,15,148,22,401,10062,9773,,
2020-05-13T17:00:00,ITA,01,Piemonte,45.0732745,7.680687483,1858,122,1980,10511,12491,-693,169,13107,3460,29058,224788,154504,,
2020-05-13T17:00:00,ITA,16,Puglia,41.12559576,16.86736689,310,27,337,1985,2322,-99,11,1566,460,4348,83713,58383,,
2020-05-13T17:00:00,ITA,20,Sardegna,39.21531192,9.110616306,78,10,88,403,491,-15,1,734,120,1345,36710,32449,,
2020-05-13T17:00:00,ITA,19,Sicilia,38.11569725,13.3623567,212,13,225,1664,1889,-22,11,1203,262,3354,107991,96860,,
2020-05-13T17:00:00,ITA,09,Toscana,43.76923077,11.25588885,284,72,356,3207,3563,-278,27,5302,964,9829,189026,138465,,
2020-05-13T17:00:00,ITA,04,P.A. Trento,46.06893511,11.12123097,76,9,85,488,573,-94,9,3293,446,4312,57997,34662,,
2020-05-13T17:00:00,ITA,10,Umbria,43.10675841,12.38824698,36,4,40,66,106,-3,0,1241,72,1419,50731,35313,,
2020-05-13T17:00:00,ITA,02,Valle d'Aosta,45.73750286,7.320149366,38,0,38,55,93,-11,3,929,141,1163,10777,8254,,
2020-05-13T17:00:00,ITA,05,Veneto,45.43490485,12.33845213,364,30,394,4626,5020,-170,31,12081,1712,18813,463154,257017,,
>>>>>>> upstream/master
=======
2020-05-14T17:00:00,ITA,13,Abruzzo,42.35122196,13.39843823,215,6,221,1261,1482,-7,9,1275,379,3136,52860,36844,,
2020-05-14T17:00:00,ITA,17,Basilicata,40.63947052,15.80514834,34,1,35,92,127,-4,0,235,27,389,20285,19789,,
2020-05-14T17:00:00,ITA,04,P.A. Bolzano,46.49933453,11.35662422,54,7,61,319,380,-33,3,1908,290,2578,52015,23487,,
2020-05-14T17:00:00,ITA,18,Calabria,38.90597598,16.59440194,59,2,61,463,524,-27,3,524,95,1143,51050,49196,,
2020-05-14T17:00:00,ITA,15,Campania,40.83956555,14.25084984,387,19,406,1359,1765,-50,9,2480,394,4639,127938,57684,,
2020-05-14T17:00:00,ITA,08,Emilia-Romagna,44.49436681,11.3417208,861,122,983,5318,6301,-201,77,16825,3930,27056,248591,158371,,
2020-05-14T17:00:00,ITA,06,Friuli Venezia Giulia,45.6494354,13.76813649,149,2,151,619,770,-9,5,2074,317,3161,97000,60177,,
2020-05-14T17:00:00,ITA,12,Lazio,41.89277044,12.48366722,1178,79,1257,2839,4096,-139,41,2600,595,7291,192917,153894,,
2020-05-14T17:00:00,ITA,07,Liguria,44.41149315,8.9326992,408,35,443,2217,2660,-58,65,5006,1329,8995,74248,44390,,
2020-05-14T17:00:00,ITA,03,Lombardia,45.46679409,9.190347404,4818,297,5115,24841,29956,-76,522,38568,15296,83820,538243,318289,,
2020-05-14T17:00:00,ITA,11,Marche,43.61675973,13.5188753,189,18,207,2697,2904,-109,15,2725,974,6603,82840,53030,,
2020-05-14T17:00:00,ITA,14,Molise,41.55774754,14.65916051,10,1,11,218,229,-2,2,152,22,403,10227,10052,,
2020-05-14T17:00:00,ITA,01,Piemonte,45.0732745,7.680687483,1775,116,1891,10000,11891,-600,151,13825,3493,29209,232682,158112,,
2020-05-14T17:00:00,ITA,16,Puglia,41.12559576,16.86736689,296,24,320,1933,2253,-69,9,1643,461,4357,85577,59815,,
2020-05-14T17:00:00,ITA,20,Sardegna,39.21531192,9.110616306,76,10,86,379,465,-26,0,755,125,1345,38034,33526,dc-IT-0028,dc-EN-0028
2020-05-14T17:00:00,ITA,19,Sicilia,38.11569725,13.3623567,203,12,215,1639,1854,-35,12,1249,263,3366,111137,99900,,
2020-05-14T17:00:00,ITA,09,Toscana,43.76923077,11.25588885,269,68,337,3051,3388,-175,30,5498,973,9859,193182,141430,,
2020-05-14T17:00:00,ITA,04,P.A. Trento,46.06893511,11.12123097,66,9,75,430,505,-68,3,3362,448,4315,60843,36359,,
2020-05-14T17:00:00,ITA,10,Umbria,43.10675841,12.38824698,26,1,27,65,92,-14,1,1255,73,1420,52247,36495,,
2020-05-14T17:00:00,ITA,02,Valle d'Aosta,45.73750286,7.320149366,38,0,38,42,80,-13,3,945,141,1166,11100,8537,,
2020-05-14T17:00:00,ITA,05,Veneto,45.43490485,12.33845213,342,26,368,4350,4718,-302,32,12384,1743,18845,474488,260706,,
>>>>>>> upstream/master
=======
2020-05-15T17:00:00,ITA,13,Abruzzo,42.35122196,13.39843823,205,6,211,1243,1454,-28,12,1313,381,3148,54028,37587,,
2020-05-15T17:00:00,ITA,17,Basilicata,40.63947052,15.80514834,33,1,34,86,120,-7,0,242,27,389,20851,20359,,
2020-05-15T17:00:00,ITA,21,P.A. Bolzano,46.49933453,11.35662422,50,5,55,304,359,-21,0,1929,290,2578,52939,23969,,
2020-05-15T17:00:00,ITA,18,Calabria,38.90597598,16.59440194,56,2,58,447,505,-19,1,544,95,1144,52701,50847,,
2020-05-15T17:00:00,ITA,15,Campania,40.83956555,14.25084984,341,17,358,1378,1736,-29,15,2522,396,4654,131544,59162,,
2020-05-15T17:00:00,ITA,08,Emilia-Romagna,44.49436681,11.3417208,763,114,877,5124,6001,-300,54,17166,3943,27110,253497,160622,,
2020-05-15T17:00:00,ITA,06,Friuli Venezia Giulia,45.6494354,13.76813649,80,3,83,658,741,-29,14,2116,318,3175,100400,62319,,
2020-05-15T17:00:00,ITA,12,Lazio,41.89277044,12.48366722,1173,79,1252,2836,4088,-8,73,2672,604,7364,197599,157880,dc-IT-0030,dc-EN-0030
2020-05-15T17:00:00,ITA,07,Liguria,44.41149315,8.9326992,385,31,416,2187,2603,-57,65,5121,1336,9060,76012,45307,,
2020-05-15T17:00:00,ITA,03,Lombardia,45.46679409,9.190347404,4705,276,4981,22765,27746,-2210,299,40962,15411,84119,550405,325071,,
2020-05-15T17:00:00,ITA,11,Marche,43.61675973,13.5188753,178,18,196,2599,2795,-109,16,2847,977,6619,84351,53813,,
2020-05-15T17:00:00,ITA,14,Molise,41.55774754,14.65916051,8,2,10,217,227,-2,4,158,22,407,10468,10281,,
2020-05-15T17:00:00,ITA,01,Piemonte,45.0732745,7.680687483,1593,108,1701,9412,11113,-778,137,14676,3557,29346,239507,161854,,
2020-05-15T17:00:00,ITA,16,Puglia,41.12559576,16.86736689,285,23,308,1873,2181,-72,9,1724,461,4366,87687,60613,,
2020-05-15T17:00:00,ITA,20,Sardegna,39.21531192,9.110616306,75,10,85,376,461,-4,3,762,125,1348,39844,34864,,
2020-05-15T17:00:00,ITA,19,Sicilia,38.11569725,13.3623567,198,11,209,1551,1760,-94,8,1351,263,3374,112929,101487,,
2020-05-15T17:00:00,ITA,09,Toscana,43.76923077,11.25588885,238,67,305,2863,3168,-220,24,5739,976,9883,197365,144237,,
2020-05-15T17:00:00,ITA,22,P.A. Trento,46.06893511,11.12123097,53,9,62,344,406,-99,3,3461,451,4318,63700,38273,,
2020-05-15T17:00:00,ITA,10,Umbria,43.10675841,12.38824698,25,2,27,63,90,-2,2,1259,73,1422,53801,37660,,
2020-05-15T17:00:00,ITA,02,Valle d'Aosta,45.73750286,7.320149366,37,0,37,40,77,-3,6,953,142,1172,11413,8814,,
2020-05-15T17:00:00,ITA,05,Veneto,45.43490485,12.33845213,311,24,335,4104,4439,-279,44,12688,1762,18889,484639,264091,,
>>>>>>> upstream/master
=======
2020-05-16T17:00:00,ITA,13,Abruzzo,42.35122196,13.39843823,195,7,202,1221,1423,-31,30,1372,383,3178,55672,38681,,
2020-05-16T17:00:00,ITA,17,Basilicata,40.63947052,15.80514834,29,1,30,83,113,-7,1,250,27,390,21496,20966,,
2020-05-16T17:00:00,ITA,21,P.A. Bolzano,46.49933453,11.35662422,48,5,53,290,343,-16,0,1945,290,2578,53703,24316,,
2020-05-16T17:00:00,ITA,18,Calabria,38.90597598,16.59440194,56,2,58,416,474,-31,7,582,95,1151,54091,52257,,
2020-05-16T17:00:00,ITA,15,Campania,40.83956555,14.25084984,351,16,367,1343,1710,-26,14,2562,396,4668,136261,61574,,
2020-05-16T17:00:00,ITA,08,Emilia-Romagna,44.49436681,11.3417208,740,112,852,5000,5852,-149,72,17370,3960,27182,258274,163067,,
2020-05-16T17:00:00,ITA,06,Friuli Venezia Giulia,45.6494354,13.76813649,79,3,82,598,680,-61,8,2184,319,3183,101694,63251,,
2020-05-16T17:00:00,ITA,12,Lazio,41.89277044,12.48366722,1156,76,1232,2790,4022,-66,32,2758,616,7396,201938,161405,,
2020-05-16T17:00:00,ITA,07,Liguria,44.41149315,8.9326992,369,26,395,2138,2533,-70,51,5232,1346,9111,78068,46304,,
2020-05-16T17:00:00,ITA,03,Lombardia,45.46679409,9.190347404,4521,268,4789,22890,27679,-67,399,41389,15450,84518,564550,333243,,
2020-05-16T17:00:00,ITA,11,Marche,43.61675973,13.5188753,154,17,171,2486,2657,-138,23,3003,982,6642,87211,54804,,
2020-05-16T17:00:00,ITA,14,Molise,41.55774754,14.65916051,8,2,10,205,215,-12,3,173,22,410,10859,10666,,
2020-05-16T17:00:00,ITA,01,Piemonte,45.0732745,7.680687483,1562,100,1662,9040,10702,-411,137,15187,3594,29483,245075,165849,,
2020-05-16T17:00:00,ITA,16,Puglia,41.12559576,16.86736689,272,22,294,1810,2104,-77,8,1807,463,4374,89611,61942,,
2020-05-16T17:00:00,ITA,20,Sardegna,39.21531192,9.110616306,75,10,85,330,415,-46,4,812,125,1352,41257,35933,,
2020-05-16T17:00:00,ITA,19,Sicilia,38.11569725,13.3623567,159,12,171,1488,1659,-101,8,1458,265,3382,114963,103103,,
2020-05-16T17:00:00,ITA,09,Toscana,43.76923077,11.25588885,234,66,300,2643,2943,-225,30,5991,979,9913,200703,145946,,
2020-05-16T17:00:00,ITA,22,P.A. Trento,46.06893511,11.12123097,44,8,52,293,345,-61,8,3528,453,4326,65383,39613,,
2020-05-16T17:00:00,ITA,10,Umbria,43.10675841,12.38824698,25,2,27,54,81,-9,0,1268,73,1422,55170,38663,,
2020-05-16T17:00:00,ITA,02,Valle d'Aosta,45.73750286,7.320149366,33,0,33,42,75,-2,1,956,142,1173,11835,9181,,
2020-05-16T17:00:00,ITA,05,Veneto,45.43490485,12.33845213,290,20,310,3852,4162,-277,39,12983,1783,18928,497045,269003,,
>>>>>>> upstream/master
=======
2020-05-17T17:00:00,ITA,13,Abruzzo,42.35122196,13.39843823,193,6,199,1223,1422,-1,8,1379,385,3186,57217,39788,,
2020-05-17T17:00:00,ITA,17,Basilicata,40.63947052,15.80514834,29,1,30,74,104,-9,2,261,27,392,22167,21627,,
2020-05-17T17:00:00,ITA,21,P.A. Bolzano,46.49933453,11.35662422,50,5,55,259,314,-29,3,1977,290,2581,54428,24677,,
2020-05-17T17:00:00,ITA,18,Calabria,38.90597598,16.59440194,56,2,58,364,422,-52,0,634,95,1151,55304,53470,,
2020-05-17T17:00:00,ITA,15,Campania,40.83956555,14.25084984,342,17,359,1337,1696,-14,16,2592,396,4684,139787,63039,,
2020-05-17T17:00:00,ITA,08,Emilia-Romagna,44.49436681,11.3417208,721,111,832,4824,5656,-196,50,17603,3973,27232,261106,163117,,
2020-05-17T17:00:00,ITA,06,Friuli Venezia Giulia,45.6494354,13.76813649,80,3,83,571,654,-26,8,2218,319,3191,104056,64558,,
2020-05-17T17:00:00,ITA,12,Lazio,41.89277044,12.48366722,1150,74,1224,2686,3910,-112,50,2914,622,7446,206166,164779,,
2020-05-17T17:00:00,ITA,07,Liguria,44.41149315,8.9326992,360,24,384,2072,2456,-77,48,5348,1355,9159,80154,47381,,
2020-05-17T17:00:00,ITA,03,Lombardia,45.46679409,9.190347404,4480,255,4735,22695,27430,-249,326,41895,15519,84844,576359,340164,,
2020-05-17T17:00:00,ITA,11,Marche,43.61675973,13.5188753,151,18,169,2396,2565,-92,25,3118,984,6667,88656,55667,,
2020-05-17T17:00:00,ITA,14,Molise,41.55774754,14.65916051,11,2,13,203,216,1,1,173,22,411,11085,10892,,
2020-05-17T17:00:00,ITA,01,Piemonte,45.0732745,7.680687483,1620,101,1721,8518,10239,-463,64,15696,3612,29547,249371,168295,,
2020-05-17T17:00:00,ITA,16,Puglia,41.12559576,16.86736689,263,21,284,1733,2017,-87,5,1892,470,4379,91035,62886,,
2020-05-17T17:00:00,ITA,20,Sardegna,39.21531192,9.110616306,76,10,86,319,405,-10,1,823,125,1353,42249,36736,,
2020-05-17T17:00:00,ITA,19,Sicilia,38.11569725,13.3623567,145,13,158,1397,1555,-104,6,1566,267,3388,117426,105074,,
2020-05-17T17:00:00,ITA,09,Toscana,43.76923077,11.25588885,214,67,281,2521,2802,-141,35,6162,984,9948,204022,148060,,
2020-05-17T17:00:00,ITA,22,P.A. Trento,46.06893511,11.12123097,41,8,49,252,301,-44,12,3584,453,4338,69659,41383,,
2020-05-17T17:00:00,ITA,10,Umbria,43.10675841,12.38824698,25,2,27,51,78,-3,2,1273,73,1424,55956,39272,,
2020-05-17T17:00:00,ITA,02,Valle d'Aosta,45.73750286,7.320149366,31,0,31,37,68,-7,0,962,143,1173,12169,9469,,
2020-05-17T17:00:00,ITA,05,Veneto,45.43490485,12.33845213,273,22,295,3746,4041,-121,13,13106,1794,18941,506588,272938,,
>>>>>>> upstream/master
=======
2020-05-18T17:00:00,ITA,13,Abruzzo,42.35122196,13.39843823,191,6,197,1216,1413,-9,7,1392,388,3193,57897,40345,,
2020-05-18T17:00:00,ITA,17,Basilicata,40.63947052,15.80514834,29,1,30,63,93,-11,0,272,27,392,22581,22016,,
2020-05-18T17:00:00,ITA,21,P.A. Bolzano,46.49933453,11.35662422,52,6,58,249,307,-7,1,1984,291,2582,54861,24930,,
2020-05-18T17:00:00,ITA,18,Calabria,38.90597598,16.59440194,53,2,55,346,401,-21,0,655,95,1151,56167,54333,,
2020-05-18T17:00:00,ITA,15,Campania,40.83956555,14.25084984,342,17,359,1314,1673,-23,11,2623,399,4695,143478,67155,,
2020-05-18T17:00:00,ITA,08,Emilia-Romagna,44.49436681,11.3417208,708,105,813,4712,5525,-131,35,17756,3986,27267,263888,166240,,
2020-05-18T17:00:00,ITA,06,Friuli Venezia Giulia,45.6494354,13.76813649,81,3,84,537,621,-33,7,2257,320,3198,104874,65184,,
2020-05-18T17:00:00,ITA,12,Lazio,41.89277044,12.48366722,1137,73,1210,2616,3826,-84,39,3031,628,7485,209472,167859,,
2020-05-18T17:00:00,ITA,07,Liguria,44.41149315,8.9326992,360,23,383,1956,2339,-117,32,5485,1367,9191,81485,47984,,
2020-05-18T17:00:00,ITA,03,Lombardia,45.46679409,9.190347404,4482,252,4734,22339,27073,-357,175,42403,15543,85019,581437,343213,,
2020-05-18T17:00:00,ITA,11,Marche,43.61675973,13.5188753,156,17,173,2142,2315,-250,11,3379,984,6678,89085,55988,,
2020-05-18T17:00:00,ITA,14,Molise,41.55774754,14.65916051,9,2,11,206,217,1,11,183,22,422,11514,11285,,
2020-05-18T17:00:00,ITA,01,Piemonte,45.0732745,7.680687483,1589,99,1688,8186,9874,-365,72,16113,3632,29619,253479,170556,,
2020-05-18T17:00:00,ITA,16,Puglia,41.12559576,16.86736689,254,22,276,1719,1995,-22,7,1920,471,4386,91901,63403,,
2020-05-18T17:00:00,ITA,20,Sardegna,39.21531192,9.110616306,72,10,82,298,380,-25,0,847,126,1353,43387,37684,,
2020-05-18T17:00:00,ITA,19,Sicilia,38.11569725,13.3623567,137,13,150,1389,1539,-16,7,1589,267,3395,118859,106277,,
2020-05-18T17:00:00,ITA,09,Toscana,43.76923077,11.25588885,197,66,263,2310,2573,-229,13,6399,989,9961,205201,148580,,
2020-05-18T17:00:00,ITA,22,P.A. Trento,46.06893511,11.12123097,41,8,49,199,248,-53,13,3650,453,4351,70173,41383,pd-IT-0018,pd-EN-0018
2020-05-18T17:00:00,ITA,10,Umbria,43.10675841,12.38824698,24,2,26,51,77,-1,0,1274,73,1424,56279,39512,,
2020-05-18T17:00:00,ITA,02,Valle d'Aosta,45.73750286,7.320149366,30,0,30,30,60,-8,1,971,143,1174,12327,9595,,
2020-05-18T17:00:00,ITA,05,Veneto,45.43490485,12.33845213,263,22,285,3719,4004,-37,9,13143,1803,18950,513021,275851,,
>>>>>>> upstream/master
=======
2020-05-19T17:00:00,ITA,13,Abruzzo,42.35122196,13.39843823,188,6,194,1195,1389,-24,4,1419,389,3197,58945,41162,,
2020-05-19T17:00:00,ITA,17,Basilicata,40.63947052,15.80514834,26,1,27,57,84,-9,1,282,27,393,23347,22767,,
2020-05-19T17:00:00,ITA,21,P.A. Bolzano,46.49933453,11.35662422,46,6,52,256,308,1,5,1988,291,2587,55526,25263,,
2020-05-19T17:00:00,ITA,18,Calabria,38.90597598,16.59440194,50,2,52,330,382,-19,2,676,95,1153,57310,55270,,
2020-05-19T17:00:00,ITA,15,Campania,40.83956555,14.25084984,330,17,347,1171,1518,-155,12,2790,399,4707,147225,69264,,
2020-05-19T17:00:00,ITA,08,Emilia-Romagna,44.49436681,11.3417208,670,99,769,4561,5330,-195,47,17987,3997,27314,268200,168367,,
2020-05-19T17:00:00,ITA,06,Friuli Venezia Giulia,45.6494354,13.76813649,76,2,78,522,600,-21,5,2283,320,3203,105656,65476,,
2020-05-19T17:00:00,ITA,12,Lazio,41.89277044,12.48366722,1124,74,1198,2588,3786,-40,20,3079,640,7505,213877,171353,,
2020-05-19T17:00:00,ITA,07,Liguria,44.41149315,8.9326992,338,22,360,1904,2264,-75,66,5617,1376,9257,83593,49038,,
2020-05-19T17:00:00,ITA,03,Lombardia,45.46679409,9.190347404,4426,244,4670,22621,27291,218,462,42593,15597,85481,596355,353579,,
2020-05-19T17:00:00,ITA,11,Marche,43.61675973,13.5188753,144,17,161,1967,2128,-187,-3,3561,986,6675,89985,56668,dc-IT-0032,dc-EN-0032
2020-05-19T17:00:00,ITA,14,Molise,41.55774754,14.65916051,9,2,11,201,212,-5,0,188,22,422,11592,11354,,
2020-05-19T17:00:00,ITA,01,Piemonte,45.0732745,7.680687483,1579,96,1675,7960,9635,-239,108,16413,3679,29727,258489,173201,,
2020-05-19T17:00:00,ITA,16,Puglia,41.12559576,16.86736689,247,22,269,1672,1941,-54,10,1982,473,4396,93834,64779,,
2020-05-19T17:00:00,ITA,20,Sardegna,39.21531192,9.110616306,71,9,80,261,341,-39,1,887,126,1354,44413,38503,,
2020-05-19T17:00:00,ITA,19,Sicilia,38.11569725,13.3623567,125,12,137,1387,1524,-15,8,1611,268,3403,122040,109195,,
2020-05-19T17:00:00,ITA,09,Toscana,43.76923077,11.25588885,190,56,246,2077,2323,-250,7,6653,992,9968,209161,151093,,
2020-05-19T17:00:00,ITA,22,P.A. Trento,46.06893511,11.12123097,42,8,50,154,204,-44,7,3699,455,4358,70691,42125,,
2020-05-19T17:00:00,ITA,10,Umbria,43.10675841,12.38824698,25,2,27,39,66,-11,3,1287,74,1427,57822,40651,,
2020-05-19T17:00:00,ITA,02,Valle d'Aosta,45.73750286,7.320149366,26,1,27,22,49,-11,1,983,143,1175,12663,9862,,
2020-05-19T17:00:00,ITA,05,Veneto,45.43490485,12.33845213,259,18,277,3477,3754,-250,47,13423,1820,18997,523800,280629,,
>>>>>>> upstream/master
=======
2020-05-20T17:00:00,ITA,13,Abruzzo,42.35122196,13.39843823,185,6,191,1126,1317,-72,8,1499,389,3205,61123,42244,,
2020-05-20T17:00:00,ITA,17,Basilicata,40.63947052,15.80514834,22,1,23,50,73,-11,0,293,27,393,23986,23376,,
2020-05-20T17:00:00,ITA,21,P.A. Bolzano,46.49933453,11.35662422,43,5,48,224,272,-36,0,2024,291,2587,56310,25601,,
2020-05-20T17:00:00,ITA,18,Calabria,38.90597598,16.59440194,49,1,50,303,353,-29,3,707,96,1156,58468,56209,,
2020-05-20T17:00:00,ITA,15,Campania,40.83956555,14.25084984,318,12,330,1112,1442,-76,7,2871,401,4714,150764,71118,,
2020-05-20T17:00:00,ITA,08,Emilia-Romagna,44.49436681,11.3417208,626,96,722,4376,5098,-232,50,18258,4008,27364,274362,171903,,
2020-05-20T17:00:00,ITA,06,Friuli Venezia Giulia,45.6494354,13.76813649,76,2,78,518,596,-4,6,2291,322,3209,108671,67449,,
2020-05-20T17:00:00,ITA,12,Lazio,41.89277044,12.48366722,1119,74,1193,2593,3786,0,28,3100,647,7533,217849,173903,,
2020-05-20T17:00:00,ITA,07,Liguria,44.41149315,8.9326992,310,22,332,1846,2178,-86,32,5725,1386,9289,85140,49819,,
2020-05-20T17:00:00,ITA,03,Lombardia,45.46679409,9.190347404,4281,231,4512,22159,26671,-620,294,43442,15662,85775,607863,359922,,
2020-05-20T17:00:00,ITA,11,Marche,43.61675973,13.5188753,125,16,141,1833,1974,-154,2,3716,987,6677,90093,57604,,
2020-05-20T17:00:00,ITA,14,Molise,41.55774754,14.65916051,7,2,9,189,198,-14,0,202,22,422,12158,11727,,
2020-05-20T17:00:00,ITA,01,Piemonte,45.0732745,7.680687483,1513,96,1609,7542,9151,-484,158,17016,3718,29885,264624,177088,,
2020-05-20T17:00:00,ITA,16,Puglia,41.12559576,16.86736689,242,21,263,1639,1902,-39,11,2027,478,4407,95895,66164,,
2020-05-20T17:00:00,ITA,20,Sardegna,39.21531192,9.110616306,68,10,78,253,331,-10,1,898,126,1355,45572,39460,,
2020-05-20T17:00:00,ITA,19,Sicilia,38.11569725,13.3623567,118,11,129,1394,1523,-1,8,1620,268,3411,123573,110205,,
2020-05-20T17:00:00,ITA,09,Toscana,43.76923077,11.25588885,178,45,223,1894,2117,-206,14,6867,998,9982,214299,154671,,
2020-05-20T17:00:00,ITA,22,P.A. Trento,46.06893511,11.12123097,39,6,45,81,126,-78,10,3787,455,4368,72031,42140,,
2020-05-20T17:00:00,ITA,10,Umbria,43.10675841,12.38824698,25,2,27,39,66,0,0,1287,74,1427,59220,41748,,
2020-05-20T17:00:00,ITA,02,Valle d'Aosta,45.73750286,7.320149366,25,1,26,20,46,-3,0,986,143,1175,12920,10079,,
2020-05-20T17:00:00,ITA,05,Veneto,45.43490485,12.33845213,255,16,271,3261,3532,-222,33,13666,1832,19030,536798,285786,,
>>>>>>> upstream/master
=======
2020-05-21T17:00:00,ITA,13,Abruzzo,42.35122196,13.39843823,175,5,180,1092,1272,-45,7,1549,391,3212,62161,42768,,
2020-05-21T17:00:00,ITA,17,Basilicata,40.63947052,15.80514834,15,1,16,44,60,-13,1,307,27,394,24537,23903,,
2020-05-21T17:00:00,ITA,21,P.A. Bolzano,46.49933453,11.35662422,50,5,55,195,250,-22,0,2046,291,2587,57104,25999,,
2020-05-21T17:00:00,ITA,18,Calabria,38.90597598,16.59440194,47,1,48,278,326,-27,0,734,96,1156,59724,57465,,
2020-05-21T17:00:00,ITA,15,Campania,40.83956555,14.25084984,312,9,321,1052,1373,-69,9,2947,403,4723,155842,73912,,
2020-05-21T17:00:00,ITA,08,Emilia-Romagna,44.49436681,11.3417208,592,92,684,4242,4926,-172,53,18466,4025,27417,278917,174485,,
2020-05-21T17:00:00,ITA,06,Friuli Venezia Giulia,45.6494354,13.76813649,72,2,74,504,578,-18,6,2314,323,3215,111541,68882,,
2020-05-21T17:00:00,ITA,12,Lazio,41.89277044,12.48366722,1110,68,1178,2459,3637,-149,25,3259,662,7558,222071,177749,,
2020-05-21T17:00:00,ITA,07,Liguria,44.41149315,8.9326992,283,22,305,1770,2075,-103,55,5872,1397,9344,87011,50812,,
2020-05-21T17:00:00,ITA,03,Lombardia,45.46679409,9.190347404,4119,226,4345,22370,26715,44,316,43649,15727,86091,622565,368046,,
2020-05-21T17:00:00,ITA,11,Marche,43.61675973,13.5188753,111,16,127,1705,1832,-142,12,3867,990,6689,91885,58667,,
2020-05-21T17:00:00,ITA,14,Molise,41.55774754,14.65916051,8,2,10,184,194,-4,1,207,22,423,12253,11819,,
2020-05-21T17:00:00,ITA,01,Piemonte,45.0732745,7.680687483,1479,83,1562,7148,8710,-441,105,17538,3742,29990,271286,179877,,
2020-05-21T17:00:00,ITA,16,Puglia,41.12559576,16.86736689,236,20,256,1583,1839,-63,6,2096,478,4413,97589,67562,,
2020-05-21T17:00:00,ITA,20,Sardegna,39.21531192,9.110616306,64,12,76,242,318,-13,1,911,127,1356,46795,40461,,
2020-05-21T17:00:00,ITA,19,Sicilia,38.11569725,13.3623567,107,11,118,1404,1522,-1,6,1627,268,3417,127348,112329,,
2020-05-21T17:00:00,ITA,09,Toscana,43.76923077,11.25588885,169,41,210,1667,1877,-240,18,7119,1004,10000,218615,157388,,
2020-05-21T17:00:00,ITA,22,P.A. Trento,46.06893511,11.12123097,40,6,46,20,66,-60,10,3857,455,4378,73849,42954,,
2020-05-21T17:00:00,ITA,10,Umbria,43.10675841,12.38824698,17,2,19,42,61,-5,2,1294,74,1429,60471,42720,,
2020-05-21T17:00:00,ITA,02,Valle d'Aosta,45.73750286,7.320149366,26,1,27,16,43,-3,1,990,143,1176,13261,10380,,
2020-05-21T17:00:00,ITA,05,Veneto,45.43490485,12.33845213,237,15,252,3034,3286,-246,8,13911,1841,19038,548573,290682,,
>>>>>>> upstream/master
=======
2020-05-22T17:00:00,ITA,13,Abruzzo,42.35122196,13.39843823,157,4,161,1018,1179,-93,8,1647,394,3220,63956,43904,,
2020-05-22T17:00:00,ITA,17,Basilicata,40.63947052,15.80514834,15,1,16,33,49,-11,0,318,27,394,25045,24395,,
2020-05-22T17:00:00,ITA,21,P.A. Bolzano,46.49933453,11.35662422,34,5,39,185,224,-26,3,2075,291,2590,58188,26585,,
2020-05-22T17:00:00,ITA,18,Calabria,38.90597598,16.59440194,47,1,48,254,302,-24,1,759,96,1157,60847,58588,,
2020-05-22T17:00:00,ITA,15,Campania,40.83956555,14.25084984,312,9,321,971,1292,-81,10,3037,404,4733,161825,76907,,
2020-05-22T17:00:00,ITA,08,Emilia-Romagna,44.49436681,11.3417208,552,89,641,4089,4730,-196,53,18703,4037,27470,282857,176464,,
2020-05-22T17:00:00,ITA,06,Friuli Venezia Giulia,45.6494354,13.76813649,68,2,70,415,485,-93,12,2417,325,3227,114062,70035,,
2020-05-22T17:00:00,ITA,12,Lazio,41.89277044,12.48366722,1111,67,1178,2457,3635,-2,31,3285,669,7589,227090,182266,,
2020-05-22T17:00:00,ITA,07,Liguria,44.41149315,8.9326992,269,19,288,1620,1908,-167,45,6074,1407,9389,89529,51771,,
2020-05-22T17:00:00,ITA,03,Lombardia,45.46679409,9.190347404,4028,207,4235,21698,25933,-782,293,44667,15784,86384,641593,378934,,
2020-05-22T17:00:00,ITA,11,Marche,43.61675973,13.5188753,101,15,116,1652,1768,-64,8,3939,990,6697,93549,59673,,
2020-05-22T17:00:00,ITA,14,Molise,41.55774754,14.65916051,8,2,10,174,184,-10,3,220,22,426,12616,12173,,
2020-05-22T17:00:00,ITA,01,Piemonte,45.0732745,7.680687483,1414,79,1493,6959,8452,-258,87,17868,3757,30077,276633,182970,,
2020-05-22T17:00:00,ITA,16,Puglia,41.12559576,16.86736689,233,17,250,1588,1838,-1,27,2120,482,4440,99702,67562,,
2020-05-22T17:00:00,ITA,20,Sardegna,39.21531192,9.110616306,58,6,64,242,306,-12,0,922,128,1356,48189,41603,,
2020-05-22T17:00:00,ITA,19,Sicilia,38.11569725,13.3623567,103,10,113,1406,1519,-3,4,1634,268,3421,129431,114230,,
2020-05-22T17:00:00,ITA,09,Toscana,43.76923077,11.25588885,162,42,204,1582,1786,-91,35,7240,1009,10035,222505,160266,,
2020-05-22T17:00:00,ITA,22,P.A. Trento,46.06893511,11.12123097,32,4,36,571,607,541,10,3326,455,4388,76001,43885,,
2020-05-22T17:00:00,ITA,10,Umbria,43.10675841,12.38824698,16,2,18,41,59,-2,0,1296,74,1429,61696,43686,,
2020-05-22T17:00:00,ITA,02,Valle d'Aosta,45.73750286,7.320149366,22,2,24,19,43,0,1,991,143,1177,13531,10607,,
2020-05-22T17:00:00,ITA,05,Veneto,45.43490485,12.33845213,215,12,227,2796,3023,-263,21,14182,1854,19059,559933,295343,,
>>>>>>> upstream/master
=======
2020-05-23T17:00:00,ITA,13,Abruzzo,42.35122196,13.39843823,156,4,160,1008,1168,-11,1,1659,394,3221,65290,44680,,
2020-05-23T17:00:00,ITA,17,Basilicata,40.63947052,15.80514834,14,1,15,26,41,-8,4,330,27,398,25511,24841,,
2020-05-23T17:00:00,ITA,21,P.A. Bolzano,46.49933453,11.35662422,35,5,40,174,214,-10,0,2085,291,2590,59671,27549,,
2020-05-23T17:00:00,ITA,18,Calabria,38.90597598,16.59440194,43,1,44,244,288,-14,0,773,96,1157,61892,59633,,
2020-05-23T17:00:00,ITA,15,Campania,40.83956555,14.25084984,295,10,305,968,1273,-19,11,3067,404,4744,166692,79655,,
2020-05-23T17:00:00,ITA,08,Emilia-Romagna,44.49436681,11.3417208,524,84,608,3962,4570,-160,43,18896,4047,27513,287382,179022,,
2020-05-23T17:00:00,ITA,06,Friuli Venezia Giulia,45.6494354,13.76813649,63,1,64,395,459,-26,6,2447,327,3233,116689,71043,,
2020-05-23T17:00:00,ITA,12,Lazio,41.89277044,12.48366722,1097,60,1157,2424,3581,-54,18,3350,676,7607,230743,185285,,
2020-05-23T17:00:00,ITA,07,Liguria,44.41149315,8.9326992,247,20,267,1467,1734,-174,38,6279,1414,9427,91735,52664,,
2020-05-23T17:00:00,ITA,03,Lombardia,45.46679409,9.190347404,4026,199,4225,21405,25630,-303,441,45355,15840,86825,658784,389648,,
2020-05-23T17:00:00,ITA,11,Marche,43.61675973,13.5188753,100,15,115,1598,1713,-55,4,3995,993,6701,94657,60232,,
2020-05-23T17:00:00,ITA,14,Molise,41.55774754,14.65916051,8,2,10,179,189,5,5,220,22,431,13017,12552,,
2020-05-23T17:00:00,ITA,01,Piemonte,45.0732745,7.680687483,1291,76,1367,6658,8025,-427,60,18341,3771,30137,281897,185963,,
2020-05-23T17:00:00,ITA,16,Puglia,41.12559576,16.86736689,215,17,232,1573,1805,-33,8,2157,486,4448,101738,68485,,
2020-05-23T17:00:00,ITA,20,Sardegna,39.21531192,9.110616306,58,6,64,223,287,-19,0,940,129,1356,49675,42790,,
2020-05-23T17:00:00,ITA,19,Sicilia,38.11569725,13.3623567,95,9,104,1408,1512,-7,0,1640,269,3421,131913,116517,,
2020-05-23T17:00:00,ITA,09,Toscana,43.76923077,11.25588885,157,40,197,1569,1766,-20,12,7270,1011,10047,226046,162433,,
2020-05-23T17:00:00,ITA,22,P.A. Trento,46.06893511,11.12123097,28,4,32,533,565,-42,7,3374,456,4395,78185,45304,,
2020-05-23T17:00:00,ITA,10,Umbria,43.10675841,12.38824698,15,2,17,39,56,-3,1,1300,74,1430,63009,44473,,
2020-05-23T17:00:00,ITA,02,Valle d'Aosta,45.73750286,7.320149366,23,2,25,10,35,-8,0,999,143,1177,13828,10858,,
2020-05-23T17:00:00,ITA,05,Veneto,45.43490485,12.33845213,205,14,219,2622,2841,-182,10,14363,1865,19069,572834,300799,,
>>>>>>> upstream/master
=======
2020-05-24T17:00:00,ITA,13,Abruzzo,42.35122196,13.39843823,149,3,152,940,1092,-76,5,1736,398,3226,66486,45516,,
2020-05-24T17:00:00,ITA,17,Basilicata,40.63947052,15.80514834,13,1,14,25,39,-2,1,333,27,399,26111,25431,,
2020-05-24T17:00:00,ITA,21,P.A. Bolzano,46.49933453,11.35662422,30,5,35,160,195,-19,3,2107,291,2593,60573,27938,,
2020-05-24T17:00:00,ITA,18,Calabria,38.90597598,16.59440194,43,1,44,231,275,-13,0,786,96,1157,62952,60693,,
2020-05-24T17:00:00,ITA,15,Campania,40.83956555,14.25084984,311,8,319,949,1268,-5,5,3076,405,4749,172106,80942,,
2020-05-24T17:00:00,ITA,08,Emilia-Romagna,44.49436681,11.3417208,519,83,602,3855,4457,-113,45,19046,4055,27558,291876,182002,,
2020-05-24T17:00:00,ITA,06,Friuli Venezia Giulia,45.6494354,13.76813649,62,1,63,349,412,-47,3,2495,329,3236,118852,72104,,
2020-05-24T17:00:00,ITA,12,Lazio,41.89277044,12.48366722,1088,61,1149,2420,3569,-12,20,3374,684,7627,233498,187994,,
2020-05-24T17:00:00,ITA,07,Liguria,44.41149315,8.9326992,247,18,265,1359,1624,-110,53,6437,1419,9480,93173,53230,,
2020-05-24T17:00:00,ITA,03,Lombardia,45.46679409,9.190347404,4017,197,4214,21400,25614,-16,285,45656,15840,87110,670241,396992,pd-IT-0020,pd-EN-0020
2020-05-24T17:00:00,ITA,11,Marche,43.61675973,13.5188753,101,13,114,1578,1692,-21,13,4028,994,6714,95715,60949,,
2020-05-24T17:00:00,ITA,14,Molise,41.55774754,14.65916051,6,2,8,175,183,-6,1,227,22,432,13226,12751,,
2020-05-24T17:00:00,ITA,01,Piemonte,45.0732745,7.680687483,1283,75,1358,6345,7703,-322,43,18694,3783,30180,285160,188716,,
2020-05-24T17:00:00,ITA,16,Puglia,41.12559576,16.86736689,204,17,221,1572,1793,-12,10,2178,487,4458,103570,71032,,
2020-05-24T17:00:00,ITA,20,Sardegna,39.21531192,9.110616306,51,3,54,191,245,-42,0,982,129,1356,50796,43661,,
2020-05-24T17:00:00,ITA,19,Sicilia,38.11569725,13.3623567,91,9,100,1353,1453,-59,2,1701,269,3423,133249,117242,,
2020-05-24T17:00:00,ITA,09,Toscana,43.76923077,11.25588885,148,38,186,1514,1700,-66,15,7349,1013,10062,229135,164469,,
2020-05-24T17:00:00,ITA,22,P.A. Trento,46.06893511,11.12123097,27,4,31,504,535,-30,9,3412,457,4404,79788,45860,,
2020-05-24T17:00:00,ITA,10,Umbria,43.10675841,12.38824698,15,2,17,36,53,-3,0,1302,75,1430,63717,45131,,
2020-05-24T17:00:00,ITA,02,Valle d'Aosta,45.73750286,7.320149366,23,1,24,8,32,-3,1,1003,143,1178,14079,11035,,
2020-05-24T17:00:00,ITA,05,Veneto,45.43490485,12.33845213,185,11,196,2464,2660,-181,17,14557,1869,19086,582709,304944,,
>>>>>>> upstream/master
=======
2020-05-25T17:00:00,ITA,13,Abruzzo,42.35122196,13.39843823,149,3,152,894,1046,-46,1,1781,400,3227,67468,46146,,
2020-05-25T17:00:00,ITA,17,Basilicata,40.63947052,15.80514834,13,0,13,23,36,-3,0,336,27,399,26634,25944,,
2020-05-25T17:00:00,ITA,21,P.A. Bolzano,46.49933453,11.35662422,29,5,34,150,184,-11,0,2118,291,2593,61075,28189,,
2020-05-25T17:00:00,ITA,18,Calabria,38.90597598,16.59440194,42,1,43,221,264,-11,0,797,96,1157,63508,61249,,
2020-05-25T17:00:00,ITA,15,Campania,40.83956555,14.25084984,287,7,294,919,1213,-55,6,3137,405,4755,175466,82786,,
2020-05-25T17:00:00,ITA,08,Emilia-Romagna,44.49436681,11.3417208,514,82,596,3763,4359,-98,29,19160,4068,27587,294181,183187,,
2020-05-25T17:00:00,ITA,06,Friuli Venezia Giulia,45.6494354,13.76813649,62,1,63,323,386,-26,4,2525,329,3240,120123,73079,,
2020-05-25T17:00:00,ITA,12,Lazio,41.89277044,12.48366722,1085,60,1145,2409,3554,-15,16,3401,688,7643,235840,190052,,
2020-05-25T17:00:00,ITA,07,Liguria,44.41149315,8.9326992,236,18,254,1302,1556,-68,17,6516,1425,9497,94472,53791,,
2020-05-25T17:00:00,ITA,03,Lombardia,45.46679409,9.190347404,3721,196,3917,21298,25215,-399,148,46169,15874,87258,675882,400252,,
2020-05-25T17:00:00,ITA,11,Marche,43.61675973,13.5188753,95,13,108,1554,1662,-30,2,4059,995,6716,96270,61347,,
2020-05-25T17:00:00,ITA,14,Molise,41.55774754,14.65916051,5,2,7,170,177,-6,0,233,22,432,13315,12819,,
2020-05-25T17:00:00,ITA,01,Piemonte,45.0732745,7.680687483,1227,72,1299,6197,7496,-207,48,18934,3798,30228,288018,191129,,
2020-05-25T17:00:00,ITA,16,Puglia,41.12559576,16.86736689,190,15,205,1473,1678,-115,9,2298,491,4467,104670,72042,,
2020-05-25T17:00:00,ITA,20,Sardegna,39.21531192,9.110616306,49,3,52,179,231,-14,-2,994,129,1354,51073,43924,dc-IT-0034,dc-EN-0034
2020-05-25T17:00:00,ITA,19,Sicilia,38.11569725,13.3623567,89,9,98,1335,1433,-20,4,1724,270,3427,135261,118208,,
2020-05-25T17:00:00,ITA,09,Toscana,43.76923077,11.25588885,152,37,189,1447,1636,-64,5,7416,1015,10067,230273,165114,,
2020-05-25T17:00:00,ITA,22,P.A. Trento,46.06893511,11.12123097,27,4,31,486,517,-18,1,3430,458,4405,80454,45531,,
2020-05-25T17:00:00,ITA,10,Umbria,43.10675841,12.38824698,15,2,17,29,46,-7,0,1309,75,1430,63916,45268,,
2020-05-25T17:00:00,ITA,02,Valle d'Aosta,45.73750286,7.320149366,19,1,20,13,33,1,1,1003,143,1179,14175,11123,,
2020-05-25T17:00:00,ITA,05,Veneto,45.43490485,12.33845213,179,10,189,2389,2578,-82,11,14641,1878,19097,590179,308128,,
>>>>>>> upstream/master
=======
2020-05-26T17:00:00,ITA,13,Abruzzo,42.35122196,13.39843823,142,3,145,764,909,-137,3,1921,400,3230,68733,46960,,
2020-05-26T17:00:00,ITA,17,Basilicata,40.63947052,15.80514834,8,0,8,28,36,0,0,336,27,399,27197,26807,,
2020-05-26T17:00:00,ITA,21,P.A. Bolzano,46.49933453,11.35662422,28,5,33,146,179,-5,0,2123,291,2593,61464,28401,,
2020-05-26T17:00:00,ITA,18,Calabria,38.90597598,16.59440194,41,1,42,196,238,-26,0,823,96,1157,64514,62255,,
2020-05-26T17:00:00,ITA,15,Campania,40.83956555,14.25084984,286,5,291,893,1184,-29,12,3178,405,4767,179845,85780,,
2020-05-26T17:00:00,ITA,08,Emilia-Romagna,44.49436681,11.3417208,493,80,573,3573,4146,-213,24,19389,4076,27611,297854,185125,,
2020-05-26T17:00:00,ITA,06,Friuli Venezia Giulia,45.6494354,13.76813649,59,1,60,315,375,-11,11,2547,329,3251,121412,73911,,
2020-05-26T17:00:00,ITA,12,Lazio,41.89277044,12.48366722,1083,59,1142,2396,3538,-16,18,3430,693,7661,238967,192591,,
2020-05-26T17:00:00,ITA,07,Liguria,44.41149315,8.9326992,223,19,242,1196,1438,-118,53,6681,1431,9550,96678,54918,,
2020-05-26T17:00:00,ITA,03,Lombardia,45.46679409,9.190347404,3622,183,3805,20672,24477,-738,159,47044,15896,87417,685058,405650,,
2020-05-26T17:00:00,ITA,11,Marche,43.61675973,13.5188753,94,13,107,1468,1575,-87,2,4147,996,6718,97285,61923,,
2020-05-26T17:00:00,ITA,14,Molise,41.55774754,14.65916051,5,2,7,167,174,-3,0,236,22,432,13452,12940,,
2020-05-26T17:00:00,ITA,01,Piemonte,45.0732745,7.680687483,1162,70,1232,5709,6941,-555,86,19561,3812,30314,293473,193954,,
2020-05-26T17:00:00,ITA,16,Puglia,41.12559576,16.86736689,172,17,189,1350,1539,-139,2,2436,494,4469,106873,73226,,
2020-05-26T17:00:00,ITA,20,Sardegna,39.21531192,9.110616306,41,2,43,181,224,-7,0,1000,130,1354,51968,44663,,
2020-05-26T17:00:00,ITA,19,Sicilia,38.11569725,13.3623567,83,10,93,1337,1430,-3,3,1729,271,3430,137682,120206,,
2020-05-26T17:00:00,ITA,09,Toscana,43.76923077,11.25588885,145,34,179,1343,1522,-114,3,7527,1021,10070,234796,168150,,
2020-05-26T17:00:00,ITA,22,P.A. Trento,46.06893511,11.12123097,24,3,27,486,513,-4,10,3441,461,4415,81149,45926,,
2020-05-26T17:00:00,ITA,10,Umbria,43.10675841,12.38824698,12,2,14,28,42,-4,1,1314,75,1431,65013,46044,,
2020-05-26T17:00:00,ITA,02,Valle d'Aosta,45.73750286,7.320149366,17,1,18,13,31,-2,2,1007,143,1181,14262,11190,,
2020-05-26T17:00:00,ITA,05,Veneto,45.43490485,12.33845213,177,11,188,2243,2431,-147,8,14788,1886,19105,602252,312632,,
>>>>>>> upstream/master
=======
2020-05-27T17:00:00,ITA,13,Abruzzo,42.35122196,13.39843823,138,3,141,725,866,-43,5,1969,400,3235,70473,48112,,
2020-05-27T17:00:00,ITA,17,Basilicata,40.63947052,15.80514834,7,0,7,29,36,0,0,336,27,399,27734,27344,,
2020-05-27T17:00:00,ITA,21,P.A. Bolzano,46.49933453,11.35662422,27,5,32,139,171,-8,0,2131,291,2593,62247,28809,,
2020-05-27T17:00:00,ITA,18,Calabria,38.90597598,16.59440194,35,1,36,154,190,-48,1,872,96,1158,65631,63372,,
2020-05-27T17:00:00,ITA,15,Campania,40.83956555,14.25084984,275,6,281,865,1146,-38,6,3221,406,4773,185724,88874,,
2020-05-27T17:00:00,ITA,08,Emilia-Romagna,44.49436681,11.3417208,459,78,537,3461,3998,-148,16,19546,4083,27627,301568,186933,,
2020-05-27T17:00:00,ITA,06,Friuli Venezia Giulia,45.6494354,13.76813649,51,1,52,304,356,-19,4,2568,331,3255,123063,74332,,
2020-05-27T17:00:00,ITA,12,Lazio,41.89277044,12.48366722,1062,65,1127,2361,3488,-50,11,3483,701,7672,242287,195001,,
2020-05-27T17:00:00,ITA,07,Liguria,44.41149315,8.9326992,205,14,219,1050,1269,-169,39,6882,1438,9589,98835,55899,,
2020-05-27T17:00:00,ITA,03,Lombardia,45.46679409,9.190347404,3626,175,3801,20236,24037,-440,384,47810,15954,87801,697561,413483,,
2020-05-27T17:00:00,ITA,11,Marche,43.61675973,13.5188753,90,13,103,1347,1450,-125,0,4272,996,6718,98535,62815,,
2020-05-27T17:00:00,ITA,14,Molise,41.55774754,14.65916051,3,2,5,161,166,-8,2,246,22,434,13629,13087,,
2020-05-27T17:00:00,ITA,01,Piemonte,45.0732745,7.680687483,1118,68,1186,5278,6464,-477,73,20095,3828,30387,298571,196790,,
2020-05-27T17:00:00,ITA,16,Puglia,41.12559576,16.86736689,170,17,187,1326,1513,-26,10,2471,495,4479,109499,74686,,
2020-05-27T17:00:00,ITA,20,Sardegna,39.21531192,9.110616306,41,2,43,172,215,-9,1,1010,130,1355,53294,45745,,
2020-05-27T17:00:00,ITA,19,Sicilia,38.11569725,13.3623567,73,10,83,1235,1318,-112,5,1845,272,3435,140295,122130,,
2020-05-27T17:00:00,ITA,09,Toscana,43.76923077,11.25588885,132,31,163,1297,1460,-62,12,7595,1027,10082,238667,170802,,
2020-05-27T17:00:00,ITA,22,P.A. Trento,46.06893511,11.12123097,19,2,21,456,477,-36,7,3483,462,4422,82269,46350,,
2020-05-27T17:00:00,ITA,10,Umbria,43.10675841,12.38824698,13,2,15,17,32,-10,0,1324,75,1431,66219,46975,,
2020-05-27T17:00:00,ITA,02,Valle d'Aosta,45.73750286,7.320149366,17,1,18,9,27,-4,0,1011,143,1181,14459,11322,,
2020-05-27T17:00:00,ITA,05,Veneto,45.43490485,12.33845213,168,9,177,2110,2287,-144,8,14931,1895,19113,616691,317690,,
>>>>>>> upstream/master
=======
2020-05-28T17:00:00,ITA,13,Abruzzo,42.35122196,13.39843823,128,3,131,693,824,-42,2,2011,402,3237,71788,49084,,
2020-05-28T17:00:00,ITA,17,Basilicata,40.63947052,15.80514834,6,0,6,28,34,-2,0,338,27,399,28342,27952,,
2020-05-28T17:00:00,ITA,21,P.A. Bolzano,46.49933453,11.35662422,16,5,21,136,157,-14,2,2147,291,2595,63289,28809,,
2020-05-28T17:00:00,ITA,18,Calabria,38.90597598,16.59440194,31,1,32,138,170,-20,0,892,96,1158,66956,64697,,
2020-05-28T17:00:00,ITA,15,Campania,40.83956555,14.25084984,260,6,266,746,1012,-134,4,3355,410,4777,189068,90670,,
2020-05-28T17:00:00,ITA,08,Emilia-Romagna,44.49436681,11.3417208,449,77,526,3224,3750,-248,74,19857,4094,27701,310696,191112,,
2020-05-28T17:00:00,ITA,06,Friuli Venezia Giulia,45.6494354,13.76813649,51,1,52,284,336,-20,7,2593,333,3262,126015,76369,,
2020-05-28T17:00:00,ITA,12,Lazio,41.89277044,12.48366722,1035,64,1099,2306,3405,-83,21,3580,708,7693,245993,198207,,
2020-05-28T17:00:00,ITA,07,Liguria,44.41149315,8.9326992,198,13,211,934,1145,-124,16,7015,1445,9605,100625,56739,,
2020-05-28T17:00:00,ITA,03,Lombardia,45.46679409,9.190347404,3470,173,3643,19270,22913,-1124,382,49296,15974,88183,713068,422568,,
2020-05-28T17:00:00,ITA,11,Marche,43.61675973,13.5188753,79,13,92,1254,1346,-104,1,4376,997,6719,100110,63611,,
2020-05-28T17:00:00,ITA,14,Molise,41.55774754,14.65916051,3,2,5,158,163,-3,1,250,22,435,13847,13266,,
2020-05-28T17:00:00,ITA,01,Piemonte,45.0732745,7.680687483,1058,64,1122,4950,6072,-392,58,20535,3838,30445,304358,199286,,
2020-05-28T17:00:00,ITA,16,Puglia,41.12559576,16.86736689,164,16,180,1215,1395,-118,2,2590,496,4481,111946,75959,,
2020-05-28T17:00:00,ITA,20,Sardegna,39.21531192,9.110616306,38,2,40,160,200,-15,0,1025,130,1355,54587,46815,,
2020-05-28T17:00:00,ITA,19,Sicilia,38.11569725,13.3623567,72,8,80,1065,1145,-173,3,2021,272,3438,142516,122600,,
2020-05-28T17:00:00,ITA,09,Toscana,43.76923077,11.25588885,126,27,153,1227,1380,-80,4,7677,1029,10086,242687,173406,,
2020-05-28T17:00:00,ITA,22,P.A. Trento,46.06893511,11.12123097,17,3,20,438,458,-19,3,3505,462,4425,83018,46735,,
2020-05-28T17:00:00,ITA,10,Umbria,43.10675841,12.38824698,14,2,16,17,33,1,0,1323,75,1431,67458,47920,,
2020-05-28T17:00:00,ITA,02,Valle d'Aosta,45.73750286,7.320149366,16,0,16,7,23,-4,1,1016,143,1182,14653,11487,,
2020-05-28T17:00:00,ITA,05,Veneto,45.43490485,12.33845213,148,9,157,1868,2025,-262,12,15202,1898,19125,632124,323097,,
>>>>>>> upstream/master
=======
2020-05-29T17:00:00,ITA,13,Abruzzo,42.35122196,13.39843823,122,3,125,645,770,-54,0,2063,404,3237,73301,50043,,
2020-05-29T17:00:00,ITA,17,Basilicata,40.63947052,15.80514834,5,0,5,28,33,-1,0,339,27,399,28909,28209,,
2020-05-29T17:00:00,ITA,21,P.A. Bolzano,46.49933453,11.35662422,17,5,22,132,154,-3,0,2150,291,2595,64105,29680,,
2020-05-29T17:00:00,ITA,18,Calabria,38.90597598,16.59440194,25,1,26,133,159,-11,0,902,97,1158,68131,65872,,
2020-05-29T17:00:00,ITA,15,Campania,40.83956555,14.25084984,236,7,243,743,986,-26,10,3390,411,4787,193669,93464,,
2020-05-29T17:00:00,ITA,08,Emilia-Romagna,44.49436681,11.3417208,429,76,505,3059,3564,-186,38,20073,4102,27739,316909,193318,,
2020-05-29T17:00:00,ITA,06,Friuli Venezia Giulia,45.6494354,13.76813649,45,2,47,276,323,-13,5,2611,333,3267,130838,78151,,
2020-05-29T17:00:00,ITA,12,Lazio,41.89277044,12.48366722,817,59,876,2287,3163,-242,16,3825,721,7709,249267,201082,,
2020-05-29T17:00:00,ITA,07,Liguria,44.41149315,8.9326992,192,13,205,789,994,-151,14,7173,1452,9619,102173,57376,,
2020-05-29T17:00:00,ITA,03,Lombardia,45.46679409,9.190347404,3552,173,3725,18958,22683,-230,354,49842,16012,88537,727146,430863,,
2020-05-29T17:00:00,ITA,11,Marche,43.61675973,13.5188753,69,9,78,1274,1352,6,4,4385,986,6723,101389,64361,dc-IT-0035,dc-EN-0035
2020-05-29T17:00:00,ITA,14,Molise,41.55774754,14.65916051,3,2,5,157,162,-1,1,252,22,436,14109,13506,,
2020-05-29T17:00:00,ITA,01,Piemonte,45.0732745,7.680687483,1029,61,1090,4568,5658,-414,56,20992,3851,30501,309497,202227,,
2020-05-29T17:00:00,ITA,16,Puglia,41.12559576,16.86736689,158,12,170,1113,1283,-112,1,2699,500,4482,114588,77211,,
2020-05-29T17:00:00,ITA,20,Sardegna,39.21531192,9.110616306,37,2,39,151,190,-10,1,1036,130,1356,55831,47841,,
2020-05-29T17:00:00,ITA,19,Sicilia,38.11569725,13.3623567,67,7,74,1063,1137,-8,2,2031,272,3440,145979,125340,,
2020-05-29T17:00:00,ITA,09,Toscana,43.76923077,11.25588885,111,31,142,1113,1255,-125,2,7802,1031,10088,246052,175489,,
2020-05-29T17:00:00,ITA,22,P.A. Trento,46.06893511,11.12123097,16,3,19,391,410,-48,3,3556,462,4428,84805,47349,,
2020-05-29T17:00:00,ITA,10,Umbria,43.10675841,12.38824698,15,2,17,14,31,-2,0,1324,76,1431,68773,48873,,
2020-05-29T17:00:00,ITA,02,Valle d'Aosta,45.73750286,7.320149366,12,0,12,7,19,-4,0,1020,143,1182,14759,11572,,
2020-05-29T17:00:00,ITA,05,Veneto,45.43490485,12.33845213,137,7,144,1705,1849,-176,9,15379,1906,19134,645049,326795,,
>>>>>>> upstream/master
=======
2020-05-30T17:00:00,ITA,13,Abruzzo,42.35122196,13.39843823,122,3,125,645,770,0,0,2063,404,3237,73301,50043,nd-IT-0015,nd-EN-0015
2020-05-30T17:00:00,ITA,17,Basilicata,40.63947052,15.80514834,5,0,5,26,31,-2,0,341,27,399,29421,28685,,
2020-05-30T17:00:00,ITA,21,P.A. Bolzano,46.49933453,11.35662422,13,4,17,120,137,-17,1,2168,291,2596,65405,30308,,
2020-05-30T17:00:00,ITA,18,Calabria,38.90597598,16.59440194,23,1,24,127,151,-8,0,910,97,1158,69334,67075,,
2020-05-30T17:00:00,ITA,15,Campania,40.83956555,14.25084984,236,7,243,738,981,-5,10,3405,411,4797,198033,95903,,
2020-05-30T17:00:00,ITA,08,Emilia-Romagna,44.49436681,11.3417208,398,65,463,2816,3279,-285,20,20373,4107,27759,321373,195492,,
2020-05-30T17:00:00,ITA,06,Friuli Venezia Giulia,45.6494354,13.76813649,45,1,46,259,305,-18,4,2633,333,3271,131976,78972,,
2020-05-30T17:00:00,ITA,12,Lazio,41.89277044,12.48366722,769,58,827,2228,3055,-108,6,3932,728,7715,253388,204232,,
2020-05-30T17:00:00,ITA,07,Liguria,44.41149315,8.9326992,186,9,195,586,781,-213,32,7411,1459,9651,104892,58665,,
2020-05-30T17:00:00,ITA,03,Lombardia,45.46679409,9.190347404,3307,172,3479,18330,21809,-874,221,50870,16079,88758,741447,438415,,
2020-05-30T17:00:00,ITA,11,Marche,43.61675973,13.5188753,66,9,75,1272,1347,-5,4,4393,987,6727,102484,64947,,
2020-05-30T17:00:00,ITA,14,Molise,41.55774754,14.65916051,3,2,5,151,156,-6,0,258,22,436,14371,13734,,
2020-05-30T17:00:00,ITA,01,Piemonte,45.0732745,7.680687483,988,60,1048,4242,5290,-368,82,21435,3858,30583,315828,205102,,
2020-05-30T17:00:00,ITA,16,Puglia,41.12559576,16.86736689,150,12,162,1060,1222,-61,8,2768,500,4490,116765,78458,,
2020-05-30T17:00:00,ITA,20,Sardegna,39.21531192,9.110616306,34,2,36,150,186,-4,0,1040,130,1356,56580,48432,,
2020-05-30T17:00:00,ITA,19,Sicilia,38.11569725,13.3623567,67,7,74,925,999,-138,2,2170,273,3442,148871,127725,,
2020-05-30T17:00:00,ITA,09,Toscana,43.76923077,11.25588885,106,27,133,1033,1166,-89,12,7897,1037,10100,249441,177686,,
2020-05-30T17:00:00,ITA,22,P.A. Trento,46.06893511,11.12123097,13,3,16,350,366,-44,1,3601,462,4429,86565,47908,,
2020-05-30T17:00:00,ITA,10,Umbria,43.10675841,12.38824698,16,1,17,14,31,0,0,1324,76,1431,70023,49760,,
2020-05-30T17:00:00,ITA,02,Valle d'Aosta,45.73750286,7.320149366,13,0,13,4,17,-2,1,1023,143,1183,14972,11741,,
2020-05-30T17:00:00,ITA,05,Veneto,45.43490485,12.33845213,120,7,127,1485,1612,-237,12,15618,1916,19146,660151,331390,,
>>>>>>> upstream/master
=======
2020-05-31T17:00:00,ITA,13,Abruzzo,42.35122196,13.39843823,104,4,108,645,753,-17,7,2064,405,3244,75652,50050,pd-IT-0022,pd-EN-0022
2020-05-31T17:00:00,ITA,17,Basilicata,40.63947052,15.80514834,4,0,4,25,29,-2,0,343,27,399,29880,29130,,
2020-05-31T17:00:00,ITA,21,P.A. Bolzano,46.49933453,11.35662422,13,4,17,110,127,-10,1,2179,291,2597,66247,30790,,
2020-05-31T17:00:00,ITA,18,Calabria,38.90597598,16.59440194,22,1,23,121,144,-7,0,917,97,1158,70274,68015,,
2020-05-31T17:00:00,ITA,15,Campania,40.83956555,14.25084984,227,5,232,748,980,-1,5,3410,412,4802,201543,98096,,
2020-05-31T17:00:00,ITA,08,Emilia-Romagna,44.49436681,11.3417208,393,57,450,2713,3163,-116,31,20513,4114,27790,325482,197423,,
2020-05-31T17:00:00,ITA,06,Friuli Venezia Giulia,45.6494354,13.76813649,41,1,42,236,278,-27,2,2662,333,3273,134378,80223,,
2020-05-31T17:00:00,ITA,12,Lazio,41.89277044,12.48366722,730,57,787,2196,2983,-72,13,4010,735,7728,255474,206235,,
2020-05-31T17:00:00,ITA,07,Liguria,44.41149315,8.9326992,195,8,203,466,669,-112,12,7529,1465,9663,106363,59374,,
2020-05-31T17:00:00,ITA,03,Lombardia,45.46679409,9.190347404,3131,170,3301,17695,20996,-813,210,51860,16112,88968,753874,445930,,
2020-05-31T17:00:00,ITA,11,Marche,43.61675973,13.5188753,62,9,71,1267,1338,-9,3,4405,987,6730,103634,65617,,
2020-05-31T17:00:00,ITA,14,Molise,41.55774754,14.65916051,2,2,4,141,145,-11,0,269,22,436,14631,13985,,
2020-05-31T17:00:00,ITA,01,Piemonte,45.0732745,7.680687483,973,58,1031,4130,5161,-129,54,21609,3867,30637,319133,207714,,
2020-05-31T17:00:00,ITA,16,Puglia,41.12559576,16.86736689,143,11,154,1023,1177,-45,4,2813,504,4494,118652,79314,,
2020-05-31T17:00:00,ITA,20,Sardegna,39.21531192,9.110616306,33,2,35,150,185,-1,0,1041,130,1356,57296,49016,,
2020-05-31T17:00:00,ITA,19,Sicilia,38.11569725,13.3623567,65,7,72,914,986,-13,1,2183,274,3443,150054,128717,,
2020-05-31T17:00:00,ITA,09,Toscana,43.76923077,11.25588885,97,28,125,986,1111,-55,4,7952,1041,10104,252090,179296,,
2020-05-31T17:00:00,ITA,22,P.A. Trento,46.06893511,11.12123097,13,3,16,288,304,-62,1,3664,462,4430,88558,48665,,
2020-05-31T17:00:00,ITA,10,Umbria,43.10675841,12.38824698,15,2,17,14,31,0,0,1324,76,1431,70553,50271,,
2020-05-31T17:00:00,ITA,02,Valle d'Aosta,45.73750286,7.320149366,12,0,12,3,15,-2,1,1026,143,1184,15203,11926,,
2020-05-31T17:00:00,ITA,05,Veneto,45.43490485,12.33845213,112,6,118,1382,1500,-112,6,15734,1918,19152,669768,333834,,
>>>>>>> upstream/master
